,text,likes,comments,shares,reactions_count
0,"#NoLesPas√≥LaTarjeta | Si algo tienen en com√∫n el chavismo y la oposici√≥n disidente en el estado Carabobo es que ambos ignoran a Luis Acosta Carlez. El exmilitar busca ser nuevamente el gobernador de Carabobo, compitiendo con ocho m√°s
https://t.co/xoocEVfbOE",22051,37684,7169,66904
1,Acu√©rdense del municipio Montalban del Edo Carabobo est√° falta de gas desde hace  6 meses https://t.co/2yRrVKE1q0,70825,5005,51269,127099
2,"@Maby80 Hay que hacer una gran campa√±a nacional, donde sea obligatorio en todos los locales comerciales sea visible la taza cambiar√≠a del @BCV_ORG_VE asi podemos deslastrar la p√°gina criminal del  d√≥lar, tambi√©n hay que usar las redes, quien no cumpla que sea severamente sancionado",83464,62547,12914,158925
3,"@sundde_ve Pero es que est√°n aumentando es en Bs descaradamente.... De 15&gt;20 millones de Bs y si lo quieres en $ te lo aplican al d√≥lar bcv,no hay rollo pero el mal ya est√° hecho.... URGENTE PRECIO DE VENTA AL PUBLICO EN   LO QUE QUIERAN BS O DIVISAS PERO YAAAAAAAA",69447,32087,72647,174181
4,"@AlexandrePalla4 Profe excelente an√°lisis, de acuerdo contigo, aqu√≠ en T√°chira aun lo esperamos esta es tu casa.",45042,66488,92392,203922
5,#12Sep hoy reunidos nuestro candidato #JoseJavierQuintero con l√≠deres de la UBCH Sim√≥n Rodr√≠guez de Andr√©s Bello #Tachira rumbo a la recuperaci√≥n de nuestro estado y municipio #RescatemosAndresBello #FormoParteDeUnGranEquipo @PartidoPSUV @PSUVTachira @FreddyBernal @NellyverLugo https://t.co/TMkcSTd7vj,98109,95266,41708,235083
6,Arrepientase la. Idolatr√≠a es pecado. Y atrae maldici√≥n,66177,22883,94053,183113
7,La serie Falcon y el Soldado del Invierno ha explorado la importancia del escudo del Capit√°n Am√©rica. ¬øCu√°l es su origen? Le contamos ‚Üí https://t.co/RhGQz3mBCC https://t.co/uxbwxENKu8,51767,23439,2643,77849
8,"@BcodeVenezuela buenos d√≠as, soy cliente nuevo del banco y me entregaron una TDD sin imprimir no tiene fecha de vencimiento y no puedo afiliar ni solicitar pagoclave ni la tarjeta de coordenadas, me pueden ayudar",23578,30870,33513,87961
9,"PuebloyFANBInvencibles Desde el estado Bol√≠var con firmeza y patriotismo continuamos nuestra gran labor al servicio de la Naci√≥n.

#29Sep #GNBPacElCallaoBolivar #CEOFANB #GNBBol√≠var 
#AndaYVac√∫nate
.@PresidencialVen
.@GnbGaranteDePaz
.@GNB_CZBolivar
https://t.co/jKtlBF3cs0",94315,49460,33888,177663
10,26 a√±os de c√°rcel para dos polic√≠as de Carabobo  por muerte de un estudiante durante las protestas de 2017 https://t.co/esBih5dhTa,74181,29761,75386,179328
11,Que falta de respeto como hacemos las madres que tenemos el dinero alli y debemos comprar alimentos  y a estas alturas a√∫n nada.. De verdad que falta de respeto,6021,12796,85330,104147
12,@BcodeVenezuela ¬ø qu√© est√° pasando con el banco? Los tel√©fonos para atenci√≥n al cliente no  atienden,39288,14045,56189,109522
13,"#6Oct Ministro @CeballosIchaso1 sigue combatiendo la especulaci√≥n y fortaleciendo la econom√≠a nacional para proteger al Pueblo, supervisando implementaci√≥n en comercios de la nueva expresi√≥n del cono monetario, rumbo al Bol√≠var digital y haciendo cumplir las disposiciones del BCV https://t.co/AVBMNSTpYu",25704,45972,69664,141340
14,"As√≠ de grande es el @DvoTachira, pero DE GRANDE, que el margen de error es 0 (CERO). CUALQUIER equipo puede perder un partido de local, y no pasa nada, pierde T√°chira y es apocal√≠ptico. Que enorme.",41116,84917,66115,192148
15,"#29Ago üì∞ | Daniel Ceballos formalizar√° su candidatura ante el CNE: ""No vamos a esperar que nos digan qu√© hacer""
https://t.co/KhzB2NxM3o",57884,76706,81895,216485
16,El BCV intervendr√°: ¬øQu√© esperar para el precio del d√≥lar al atenuarse la presi√≥n causada por la reconversi√≥n monetaria? | Por: @DeisyKarina8 ‚úçüèª https://t.co/3pGs37xyWb,24481,43221,29300,97002
17,@ENZOSCARANO usted es la persona que necesita Carabobo guacara tiene un toro poderoso que lo acompa√±ara,63475,8015,36083,107573
18,"@rescatatukgdef1 @OJOVENE @Sanchez84290301 @Anabell98150439 @RamadanMezVzla @tumatachin77 @MirafloresEl @Fredypm @criszzuela @Dante27579076 @HUS07777781 @Pasajero510 @MarioNolio @1961Tokio @Samurai16157668 @Yolanda76887693 @2Viejis39 @franjav125 @indioguerrero50 @Delnacarrero @jerafervas1 @SoyDiv0 @VENEZUELAIndep1 @Tropatriunfante @RiegoPineda @LaNiaDeLaCalza1 @Florencia90102 @Fooros @jamn2007 @Maricorazon65 @caricaturasniso @3lS0ld4d0R0j0 @CarpinteroAlejo @JosePin20249686 @BoliChoro @Wutang1986 @JorgeZuluagaSi1 @me_gorra @calderjo01 @Antonio29058651 @CONDIOSYMIVZLA @Leon087770274 @Mildred37340281 @sosvzla11 @rosaurabonita @ADOLALE @rluis60 @OIlOlIl @jcy126kerubin @elgochoceballos Eeeeesooooo cuando aparezco yo de una aparece el escudero mayor, el rey de los mariconeros del Clan de la Samura: el Capit√°n Moj√≥n. C√≥mo amanecen hoy los mariconeros de la Mandraka? Me imagino que m√°s mariconeros que nunca (q apoyan a Mar√≠a Corina para q no piensen mal) ü§£ü§£ü§£ü§£",8797,56661,88919,154377
19,Deberian tambien desplegar a sus trabajadores y tecnicos en la recuperacion del sistema para q los clientes  puedan hacer uso de su dinero q hasta la fecha lo tienen retenido... eso si seria una noticia relevante.. ,19696,61733,63774,145203
20,"CON M√ÅXIMO COMPROMISO PATRIO! üëäüáªüá™
#17Oct üé• El MG Juvenal Fern√°ndez L√≥pez @GNBCmdtGral, realiz√≥ visita en el Comando de Zona @GNB41_CARABOBO acompa√±ado del Cmdte de Zona GB. @Rivera_bastardo.
#LaVerdadSiempreTriunfa
#PuebloYCEOFANBVenceremos https://t.co/SQrC4qtJkY",14778,44196,9429,68403
21,"No es el √∫nico, el de mi cuarto tambi√©n se da√±o y donde yo vivo en La Fr√≠a estado T√°chira hace un calor del HPT, jajaja disculpe por el lenguaje coloquial y gocho. Feliz d√≠a!!! üòÜüòÜüòÜ https://t.co/4S4ZXvMKku",53517,61428,23317,138262
22,"@HIDROFALCON Pero van de retroceso, ineptos. A 25 d√¨a sin agua en Comunidad Card√≤n, incapaces. No al racionamiento.",34230,69579,13772,117581
23,"M√ÅXIMO COMPROMISO PATRIO! üëäüáªüá™ #17Oct üé• El MG Juvenal Fern√°ndez L√≥pez @GNBCmdtGral, realiz√≥ visita en el Comando de Zona @GNB41_CARABOBO acompa√±ado del Cmdte de Zona GB @Rivera_bastardo
#GNBCMDTEPACPERACAL
LaVerdadSiempreTriunfa
PuebloYCEOFANBVenceremos https://t.co/Ee2t9ac0Fk",98345,43006,21449,162800
24,"via TecnoAccesorio: Buenos d√≠as ¬°Feliz Jueves!
Hermoso amanecer en Choroni, Feliz d√≠a
¬°Hoy podremos con todo!
#FelizJueves #BuenosDias #FelizDia #TecnoAccesorio #Carabobo #Valencia #SanDiego 
@sandiegovial https://t.co/gJ7Pwgrkjn #QuedateEnCasa",25730,47825,66500,140055
25,"2021-04-23 56mm en Jun√≠n, Buenos Aires, Argentina #pluviomano #gestionagro https://t.co/R7U8YEcI5p @caburearg https://t.co/R3RSZ5LyIT",92043,55493,80199,227735
26,"@DanteFontana3 Sipa el BCV 4,18",67001,56042,94641,217684
27,"@Carolapalante @Banesco En horario de oficina https://t.co/T3dmyMmV40 y te metes donde diga ""CATI asistente virtual"", all√≠ te pide el n√∫mero, te muestra las opciones y esperas a que te atiendan, te van a pedir la captura del recibo de pago que te d√° el banco y dura 24h para limpiar la deuda",18554,98709,89357,206620
28,"@NicmerEvans Que siga manteniendo su postura de valentia, de hermandad, y siga buscando la unidad plena de un pueblo necesitado @JAVIERBERTUCCI carabobo esta contigo nuestro proximo Gobernadorüëèüëèüí™",81803,24594,80023,186420
29,"üèÅInternet Alert reporta fallas de internet en Venezuela tras fuertes fluctuaciones: Diversas zonas del pa√≠s se encuentran sin electricidad en este momento son: - Distrito Capital,Miranda,Aragua, Vargas, Carabobo, T√°chira, M√©rida y Zulia.
#Vac√∫nateYa @Preferida1021",96779,19478,71606,187863
30,"Estado Mayor de #FANB en el edo Bol√≠var realiz√≥ inspecci√≥n a la Central Hidroel√©ctrica Antonio Jos√© de Sucre en Macagua, garantizando el buen funcionamiento de sus instalaciones.

#13Oct PuebloPatriota
#Mon√≥merosEsDeVenezuela
UnidosPuebloyGNBEsSoberan√≠a https://t.co/GxpU7TeV2H",48693,17112,71160,136965
31,"Inf√≥rmate en #SNE PiedrasNegras 
Agenda tu cita en üëâüëâüíªhttps://t.co/o0tiilEAFZ https://t.co/o5ushjo1bA",42588,9527,8580,60695
32,@452Vigirima @NicolasMaduro @wistohor @vladimirpadrino @dhernandezlarez @REDICentral_ @ZODI45_Carabobo @LAVOZDESJ Venceremos https://t.co/CLNLUMfolS,45449,587,74275,120311
33,@critico2_ la gente no va a querer pagar dolares en los negocios prefieren venderlos para pagar en bolivares porque ay diferencia entre el BCV y el negro,57365,78139,45746,181250
34,".üëë
#LOTTOREY
11/10/2021
3:30 pm
Sorteo#: 3588
27 Perro 

Quieres plata?JuegaLottoRey
juegal #Legal
#RT #RT  
#11Octubre
#Carabobo 
#Zulia 
#Caracas 
#margarita 
#anzoategui 
#porlamar
#bolivar
#aragua 
#oriente 
#maturin 
#cantaura
#Falcon 
#Ecuado https://t.co/Ok7cHVrQvK",12558,10195,56007,78760
35,"@zarlox @joviandsammy @YoAlejoV No veo colombianos caminando por las carreteras de apure, estado Falc√≥n, guyana, Brasil, Ecuador, Peru , Chile... En cambio 8 millones de venezolanos , muriendo en el √©xodo... Desesperados por un salario m√≠nimo de 4500 pesos mensual... Por votar por la izquierda",24457,31163,88564,144184
36,"Van 3 bajones de luz en menos de 4 horas en cd Bol√≠var , estado Bol√≠var . que vaina",18801,29041,73384,121226
37,Escuche al pueblo no puede un pa√≠s tener un sueldo de 1.800.000 esto lo ganan los funcionarios de su gobierno? ud hace pacto con la derecha!  Que paso el. Pacto de punto fijo se activo de nuevo se√±or estamos esperando cambios no creo en dictaduras creo en democracia para todos,68989,69899,49639,188527
38,"#SALUD üíâ || Caracas, Miranda, La Guaira y Carabobo suman el 75% de los casos de COVID-19 en el pa√≠s - La iguana TV ü¶é

üîé CONOCE M√ÅS üëá
https://t.co/QXiiToK6xq",82367,67211,49468,199046
39,"@salaprensaCantv un mes sin servicio de ABA Internet, en UD-145, San F√©lix, estado Bol√≠var, municipio Caron√≠, Parroquia Dalla Costa. Qui√©n resuelve? @NicolasMaduro",99002,27696,6421,133119
40,@JAVIERBERTUCCI La verdad que en Carabobo tienen que estar fum√°ndose un porro el que vaya a creer de tus mentiras pura cortina de humo .,52713,63612,5524,121849
41,que triste notar que una persona es indiferente con vos pero con el resto sigue igual de bien,24706,35414,34322,94442
42,@BcodeVenezuela En santa b√°rbara de barinas no sirven,98539,88860,77102,264501
43,"@ale_orvananos @MikelArriolaP @MarcaClaro Ese culero le va a LAS GATAS APESTOSAS DEL PEDREGAL, POR ESO DICE QUE SIGUE IGUAL ESTE PINCHE FORMATO DE MIERDA, ES PARA BENEFICIAR A LAS PERRAS CON CUERNOS Y A LAS GATAS APESTOSAS DEL PEDREGAL...ü§¨üò§ü§¨üò§ü§¨üí™üèªüí™üèªüí™üèªüí™üèªüí™üèª PINCHE LIGA MX CHAFA...‚úäüèª‚úäüèª‚úäüèª",75614,98955,69914,244483
44,@fmonaldi Mi hermosa pen√≠nsula de Paraguan√°,87960,62679,99572,250211
45,"UNA PREGUNTA EN EL SUPUESTO ATAQUE TERRORISTA, LOS TERRORISTAS IMAGINARIOS CAMBIARON LAS PREGUNTAS PARA ACTUALIZAR LA CLAVE DE SEGURIDAD? AHORA IQUE ""CREMA FAVORITA"" CUANDO JAMAS A EXISTIDO ESA PREGUNTA EN EL RENGLON ABUSADORES, SON LAS MEDIDAS QUE SIGUEN TOMANDO EN CONTRA DE LOS USUARIOS QUE DENUNCIAMOS A ESTOS LADRONES PUES A TODO EL MUNDO LE APARECE EN SUS CUENTAS SALDOS NEGATIVOS DESPUES DE QUE SU INEFICIENCIA ISIERA QUE SE CALLERA EL SISTEMA POR MAS DE 5 DIAS Y DESPUES SALIERON A DECIR QUE FUE OSAMA BIN LADEN, BOICOT SAQUEN TODOS LA PLATA DE ESTE BANCO URGENTE¬°¬°",1326,74889,58452,134667
46,Pancho P√©rez Lugo: Convertiremos a Naguanagua en el Emporio Comercial y Agrotur√≠stico de¬†Carabobo https://t.co/yKbycw9O2G,63387,56270,67268,186925
47,Cu√°ntos Tachirenses est√°n Dispuestos a Votar por el De los Bernal tanto en Ccs c√≥mo en T√†chira..? üëáü§îüëá Se pueden Imaginar El Clan Bernal en el T√†chira..? Ahora Beatriz Rodr√≠guez en Ccs ser√° qu√© es Flia del Psiquiatra..? Negocio Redondo estos es casi el Tren Rodr√≠guez y Bernal.?,99544,92982,44107,236633
48,@oficialhidroven @Hidrocentro2011 @hidrosuroeste @RMarcoTorres @EvelynBVasquez @SomosRMNoticias @RNVinformativa @VTVNoticias @delcyrodriguezv Naguanagua Edo Carabobo sin agua llevamos 5 dias,3753,31407,81755,116915
49,"Codehciu: ""La violencia contra la mujer es una violaci√≥n a los derechos humanos y un grave problema de salud p√∫blica que debe ser abordado de forma intersectorial y de forma diferenciada‚Äù

https://t.co/R6LYVm0fj1",3197,28869,22401,54467
50,"Daniel_RiosVE: Seg√∫n The Verge, Facebook planea cambiar de nombre https://t.co/FfX738aQS5 #DanielRiosTeInforma #GacetaCarabobo #Carabobo #Venezuela",93216,37702,30907,161825
51,El peso colombiano gana terreno como la moneda de mayor circulaci√≥n en T√°chira¬† https://t.co/2srGZj8Pwj,11798,97088,65279,174165
52,"#Asi se desarroll√≥ asamblea de la Comuna La Batalla de Bol√≠var en el Estado Anzo√°teg√∫i, desde el Consejo Comunal El Ed√©n. Esta jornada estuvo encabezada por el Ministro @IMVillarroel1  el Gral. C√©sar Olivero del @MinisteriodelP2 y el @MP_Comunas @NicolasMaduro #BatallaPorLaPaz https://t.co/LxoqFpNZ5y",4699,9089,91670,105458
53,@elgochoceballos Amigo v√°yase a dormir con tranquilidad no hay elecciones en Dictadura ni con una narcoregimen criminal,25675,25237,85691,136603
54,8 dias consecutivos #SinAgua mientras el Covid19 hace estragos en Valencia en la Urbanizaci√≥n La Alegria no tenemos agua ni para lavarnos las manos y todo esto en plena campa√±a politica para la gobernaci√≥n de Carabobo. @rafaellacava10 @FtorresIng @EvelynBVasquez @MinSaludVE https://t.co/P4gDqEuwPO,4231,71591,56162,131984
55,"#Atenci√≥n üáªüá™ Verificaci√≥n de precios acordes con la tasa cambiaria del @BCV_ORG_VE, habladores expresados en bol√≠vares y medidas de bioseguridad son parte de los chequeos realizados por los funcionarios del @mincomercioven 

#Soberan√≠aPatriaYPaz https://t.co/Vh1lbcb7SF",3833,59219,13572,76624
56,@TarekWiliamSaab esto si es legal? Con que poder?quien lo nombr√≥ gobernador? Ya est√°n diciendo con esto que se van a robar la elecciones del estado bolivar? https://t.co/FCVZroAKbU,40458,55251,67840,163549
57,"@Mippcivzla De coraz√≥n me alegra que se recupere la UCV, ojala se hiciera lo mismo con la Universidad de Carabobo y todas las universidades del pa√≠s. Las de Aragua est√°n en el piso.",22641,36313,52706,111660
58,"Detenida banda que prostitu√≠a a adolescentes en Carabobo | #15Oct 

https://t.co/s1zQPyyj46",37142,88287,21681,147110
59,"Estado Carabobo
 Municipio Naguanagua 
CAT Naguanagua 
#SomosContinuidad 
#20deoctubre 
#ACubaPonleCorazon 
@cubacooperave_C 
@cat_naguanagua 
@cubacooperaven 
D√≠a de la Cultura Nacional https://t.co/h4JKCPo4om",16337,64795,46568,127700
60,@ChevalierRoldan Las arepas de salchicha con salsa en la parada del Guapo a la 2am cuando iba a Punto Fijo en bus,11798,51082,58968,121848
61,@raulrivas05_1 El tradicional Hotel y Balneario Aguas Termales de las Trincheras a 15 minutos de Naguanagua v√≠a Puerto Cabello Edo. Carabobo üáªüá™,28952,68053,68057,165062
62,"Universidad Cat√≥lica:
‚ÄúTodo apunta a que, tanto en el sector p√∫blico como en el privado, este a√±o termine con ca√≠das en el salario real‚Äù.  La recuperaci√≥n salarial para 2022 depender√° de si la inflaci√≥n se ajusta a lo esperado por el gobierno.",2167,54669,49336,106172
63,"CDI SIMON BOLIVAR PEDRAZA
ESTADO BARINAS
@cubacooperaven https://t.co/m5rOMr7jYq",63812,48566,12833,125211
64,"Gob #Falc√≥n Victor Clark B. Informa sobre la detenci√≥n de cuatro (4) personas por el presunto hurto de medicamentos en almac√©n de la https://t.co/3WB01DEZRy Salud Falc√≥n. Clark, se√±alo ""vamos por todos, autores materiales e intelectuales"", el CICPC tiene que dar con todos. https://t.co/UNEKsGsZ1Z",81999,61403,45949,189351
65,"@evedecolores A mi me lo ense√±aron por all√° en Tacuato eso queda entre Coro y Punto Fijo- Y cuando vienes de regreso pasa por donde la se√±ora Katy all√≠ en Coro y compras sus dulces. Como decimos en Margarita ""no me heches m√°s cartas""",78629,177,17461,96267
66,@PMA44362148 @Parejanuevades1 Hola de que partes de punto fijo son,8158,71296,32549,112003
67,"@JAVIERBERTUCCI Definitivamente el cambio lleg√≥ a Carabobo Bertucci ser√° un gobernador incluyente eso es lo que necesita Carabobo no se puede tapar el sol con un dedo la gente est√° con Bertucci
Bertucci gobernador",43241,10377,77136,130754
68,Inspeccionan trabajos de recuperaci√≥n del √°rea de Gineco-Obstetricia del Hospital Dr. Rafael Calles Sierra en Paraguan√° https://t.co/kqmf247bof https://t.co/sD2pdC4OoF,63886,39669,42370,145925
69,@patiaceves solo para comentarle que en Tlalpan espec√≠ficamente  en la calle de Lacandones Mz 13 Lt 12 Col. Pedregal de las √Åguilas no tenemos agua desde hace 2 meses motivo por el cual pido si intervenci√≥n. Se han hecho los reportes necesarios  sin obtener resultados.,51013,47958,72068,171039
70,"Protectorado del T√°chira inici√≥ plan especial de recolecci√≥n de basura https://t.co/T16DfhVUy5  

#Vac√∫nateYA",48160,98026,72023,218209
71,As√≠ abren el d√≥lar paralelo y tasa del BCV este #5Oct¬†(+Monitor) https://t.co/mDpg6qNob5,77905,90217,95218,263340
72,"El a√±o pasado si mal no recuerdo, cuando T√°chira iba a jugar vs caracas, tambi√©n apareci√≥ el covid en el equipo y ese d√≠a Quintero tuvo su titularidad y lo hizo super bien, Dios quiera hoy se repita esa historia",78000,53493,85553,217046
73,@ebncol @Nichttot_Pazos @gastonvelandia @TocandoAndo @margaritamoon77 Pues ay propiedades que como veo si quedan para las personas que lo necesitan https://t.co/BBIZ1VWDow,77365,9141,99459,185965
74,"@tuitesocialista @BcodeVenezuela üáªüá™ üôãüèª Por BDV en l√≠nea  , sencillo

‚úä https://t.co/69zsDcukl6

üáªüá™ #AIexPresoPolitico",33480,56283,39229,128992
75,"#27Ago #Declaraciones 
Nicol√°s Maduro: ""Otros de los estados que sufrieron incidencias son: Cojedes, Delta Amacuro, Falc√≥n, Gu√°rico, La Guaira, Lara, M√©rida, Miranda, Monagas, Nueva Esparta, Sucre, T√°chira, Trujillo, Yaracuy y Zulia """,63308,82066,97750,243124
76,"Dos ni√±as resultaron lesionadas por ca√≠da de veh√≠culo en un ""mega hueco"" en Punto Fijo https://t.co/06EMeXQQhM ‚óº",12519,68487,20491,101497
77,"@Paveloropeza Pues....
üßê En la sede principal de la Universidad de Carabobo, frente a la Facultad de Econom√≠a est√° la Plaza con un Busto de Allende en la principal Avenida Universitaria que lleva por nombre Salvador Allende.",68829,29241,18842,116912
78,#19Oct  Por hurtar insumos m√©dicos: Arrestaron a empleada de oncol√≥gico en Carabobo https://t.co/tt176ahTZS,38024,10886,29970,78880
79,@luisgonzaloprz En Carabobo pero con la caida d whatsapp y Instagram Facebook la furia esta contenida üòÇüòÇüòÇ,65447,28797,88850,183094
80,"La mujer Cubana digna hero√≠na de Estos tiempos, desde el Estado del T√°chira, La Fr√≠a, se reconoce la labor de la FMC, en su #Aniversario61FMC
#H√©roesDeLaSalud
#CubaEsSolidaridad
#CubaPorLaVida
#ACubaPonleCoraz√≥n
#MMedicaCubanaTachira
@FMC_Cuba
@cubacooperaven https://t.co/FQWAlC0n3T",34397,52506,24919,111822
81,"üè°SE VENDE LINDA CASA EN CONJUNTO RESIDENCIAL PRIVADO MAGNIFICA UBICACION               
üëâ Urbanizaci√≥n Casacoima Country al lado de la Cl√≠nica de Especialidades, Av. 27 de Febrero. PUNTO FIJO TEL√âFONOS 
‚òé+584126802436 - 
‚òé+584146708309 - 
‚òé+584146968008 -
PUNTO FIJO FALC√ìN https://t.co/p7CcxDJQja",74008,56466,20400,150874
82,Daniel_RiosVE: Southwest Airlines cancela cientos de vuelos por problemas del control de tr√°fico a√©reo https://t.co/hN7RsYvu0f #DanielRiosTeInforma #Valencia #Carabobo #Venezuela,70630,80747,90904,242281
83,#Falc√≥n | De 40 a 30 litros por veh√≠culo pas√≥ la nueva distribuci√≥n de combustible en las estaciones de servicios subsidiadas. Conozca los detalles https://t.co/q0lklCJDXi,94513,47580,68341,210434
84,"#14Sep Funcionarios de @PoliciaTachira, detuvieron 01 ciudadano, el cual al ser verificado por el SIIPOL, se encuentra solicitado por el Juzgado Primero del estado T√°chira, por el delito de posesi√≥n il√≠cita de  sustancias estupefacientes y psicotr√≥picas.

#AlertasContraElSabotaje https://t.co/pHx5An9Wg1",85059,16865,45776,147700
85,"Seguimos Luchando!!! üáªüá™üí™ en Rubio, Estado Tachira https://t.co/GD1z2y2bqE",88812,14098,85285,188195
86,"#14Oct #Venezuela #Reportando baj√≥n de luz, por los momentos, en varios lugares de Caracas, Aragua y Carabobo. Y ahora #SinLuz en Caracas.",62505,55095,34253,151853
87,Terreno en Venta en Guanadito.  Punto Fijo en Punto Fijo/Falc√≥n/Venezuela en Venta https://t.co/9Ov7GbveFl,36083,38358,91732,166173
88,"""Colo Colo debe corregir el impuso que le dej√≥ jugadores suspendidos"" https://t.co/bL2QIOs6lT",72401,348,85480,158229
89,T√°chira: Este domingo #5Sep votan en primarias para definir candidatos de la MUD en Jun√≠n y C√≥rdoba https://t.co/FRtVu96NP3 https://t.co/E3Hx76jdtA,94164,6131,50452,150747
90,"@SancadillaNorte https://t.co/mkJq3SQBvl

Vendo salsas entrego en todo Monterrey
Y ya se la saben puras buenas vibras para toda la banda",97977,30267,93962,222206
91,"#ATENCION | Las fuertes lluvias de anoche causaron un derrumbe en el sector de La Ratona, v√≠a Santa Ana del Tachira, municipio C√≥rdoba. Es la √∫nica v√≠a de acceso a la zona. Habitantes caminan sobre el lodo para llegar a sus destinos. #12Sep #Tachira #Venezuela 
üì∑ Cortes√≠a https://t.co/kfc2eT38dh",53217,81380,14215,148812
92,"@BcodeVenezuela Buenas tardes,me pueden explicar porque aparece un d√©bito en mi cuenta, a qu√© se debe eso, porque a penas hoy es 7 de octubre.",51566,929,8925,61420
93,"Tenemos el Kit Nintendo DsLite por 2$, incluye: 01 Lector de Tarjeta MicroSD, 03 Protector de Pantalla y 03 L√°pices punta de goma. #Nintendo #DsLite #Game #Vende #VenVariedades #Carabobo #Valencia #SanDiego https://t.co/Aw6uHSERQT https://t.co/BZDm6oiJUu",50243,66862,38575,155680
94,üáªüá™ Experto estima que el BCV ¬´puede lograr¬ª ca√≠da en cotizaci√≥n del d√≥lar paralelo https://t.co/QNB1WU47wu,79167,20283,64947,164397
95,"Cu√°ndo Freddy Bernal @FreddyBernal fue alcalde de Caracas lo atacaron de mil maneras al punto que al salir de la alcald√≠a su reputaci√≥n no val√≠a medio

Hoy es uno de los pocos con cojones para meterse a pelear contra las mafias paracas en el TACHIRA

#SomosPatriaSoberana",84810,36844,60279,181933
96,"@gamez_manara @66MarioDeLuca1 @nica_rojaynegra @BrownSugarNic @NeyV10Jr @nicol_she @yahoska_davila @mijamart88 @Atego16 @Arjuly18 @TaniSandinista3 @ChocobolaNica @CandeloHoracio AMIGA DESDE VENEZUELA ESTADO CARABOBO
SOMOS ALEGRIA SOMOS MAYORIA SOMOS DE VERDAD
EL SOL DE VENEZUELA NACE EN EL ESEQUIBO
VIVA VENEZUELA Y VIVA NICARAGUA LIBRES SOBERANAS E INDEPENDIENTES
HASTA LA VICTORIA SIEMPRE
NECESARIO ES VENCER",88984,46130,61176,196290
97,"@Cubacooperabol2 Desde el Estado Bol√≠var mantenemos una atenci√≥n de calidad al pueblo venezolano, servicio de rehabilitaci√≥n, CDI El Roble .
#CubaPorLaVida 
@Cubacooperabol2 
@cubacooperaven 

@AnayansyPR 
@AngelGCampos3 https://t.co/J4qhNAov1j",10604,61235,22103,93942
98,"üó£üì¢ #Tachira Desde el Municipio San Crist√≥bal, en el Consejo Legislativo, estuvimos reunidos con profesionales formados en diferentes √°reas del conocimiento debatiendo el Plan de Gobierno de nuestro pr√≥ximo Gobernador @FreddyBernal 
#Amemosaltachira
#ULTIMAHORA 
üíõüñ§‚ù§ https://t.co/5KmT8t22cJ",65432,79042,57554,202028
99,"Termin√© estos 4 d√≠as sentada en el sill√≥n mirando un punto fijo por, m√≠nimo, una hora. Menos mal que ma√±ana es viernes, sino ni mi mente ni mi cuerpito resistir√≠an.",99985,51676,88151,239812
100,@Mippcivzla @SMoncada_VEN @jaarreaza @PlasenciaFelix @luis_villegasr @IgBuzMep @JEHYSONGUZMAN @ONUVENuevaYork @embajadacaracas @mfa_russia #OlaDeSolidaridadPorAlexSaab ¬°VENEZUELA denuncia a EEUU por secuestro del Diplomatico! Venceremos igual que ayer en Carabobo. @NicolasMaduro @Mippcivzla @luchaalmada @DayraMRivasR @fotoecocultura @BattleWinner3 @AuristelaAlvar5 @yanislumar @MaikelLucenaVE @OncaTvR @VTVcanal8 https://t.co/3NegGTALIC,85982,78792,61761,226535
101,Los establecimientos deben emitirla y entregarla al momento que el cliente solicite la cuenta. #ExigeTuFactura @SENIAT_Oficial @ASIST_SENIAT @EGALLARDOB https://t.co/tVfjhjwpr6,73429,70202,8506,152137
102,EN VIDEO | ¬°Inesperado! Rescataron a serpiente boa del interior de un veh√≠culo en Carabobo https://t.co/zZIy7xRjWD,61857,2850,36884,101591
103,"Alcalde Pablo Acosta Activ√≥ Brigadas de Desinfecci√≥n Comunitarias en ""Las Panelas."" https://t.co/stQu0FOoIR",99096,11135,21303,131534
104,"#9Oct|| üî¥¬°MICROTR√ÅFICO! En #Carabobo fue aprehendido sujeto por tr√°fico il√≠cito de drogas de menor cuant√≠a A/O del M.P #InvictosPorVzlaCEOFANB
#VenezuelaTieneConQu√©
.@vladimirpadrino
.@GNBCmdtGral https://t.co/AnbQdOfu9A",41558,85944,25514,153016
105,#11Oct La milicia no descansa porque nunca se cansa #RedicentralSimulacro @NicolasMaduro @vladimirpadrino @wistohor @ADI_Tacarigua  @ZODI45_Carabobo https://t.co/RI6d8C0yNW,96731,47423,23571,167725
106,@sundde_ve Ayer fui al mercado Euromax San Diego Edo carabobo y le estaban colocando nuevo precio a toda la comida,95990,60090,7096,163176
107,#13Sep #sucesos Caso incesto en #Tachira Homicida se entreg√≥ en #Colombia https://t.co/yBLc3abgWv https://t.co/qDPao2x51H,27556,46429,93466,167451
108,"@EdgardSanchez Parque Nacional M√©danos de Coro, debido a su belleza natural y por mantener el concepto de Bioma des√©rtico, adem√°s de ser el √∫nico desierto de la costa del Caribe.
#Restauraci√≥nFalc√≥n

https://t.co/uWdVdeX0vJ

https://t.co/biJSP9teb5

#31Mar https://t.co/85v7jbJA2w",74881,40701,40093,155675
109,@NataliaUrregoA @QuinteroCalle cuando empiezan a trabajar en carabobo norte en la via zamora ya ha pasado mucho tiempo. Ybuna vez escuche que ya habian empezado y nada ze nada cuenten que paso... Informen a la poblacion,44089,14824,56170,115083
110,¬øEl BCV inyect√≥ d√≥lares a los enchufados y chupamedias codependientes? https://t.co/w5UmBaoVZ3,56190,92952,15472,164614
111,"@safebzzbzz perro
Park Jimin
Pasta
P√©rez
Paraguana",15675,86040,99325,201040
112,"Durante el primer semestre de 2021 hubo al menos 279 casos de violencia en el estado Bol√≠var, de acuerdo con el monitoreo en diferentes medios de comunicaci√≥n de la regi√≥n
 https://t.co/v7oueXKuI2",78258,65851,48050,192159
113,Despues q el pueblo y agricultores sirvieron al gobierno haciendo su trabajo ahora son perseguidos y sin explicaci√≥n alguna a la parroquia guarataro municipio Sucre estado Bol√≠var,44785,82776,32710,160271
114,"#18Oct ""El mayor triunfo no sucede en los escenarios del mundo, sino en los repliegues √≠ntimos del coraz√≥n‚Äù. Feliz inicio de semana Carabobo. ¬°Aqu√≠ Nadie se Rinde! üí™üèΩüí™üèΩü¶áü¶áüáªüá™üáªüá™ #EpaVamosACuidarnos #carabobo #lacava #docentes #lunes https://t.co/Cx3xsN63gp",16504,85304,68187,169995
115,"Aseguran a beb√© migrante deambulando por las calles de Piedras Negras
https://t.co/aRJHZWYoM5
#PiedrasNegras #Beb√© #Migrante https://t.co/j8jFxSB7jv",76177,58251,13157,147585
116,"INAC autoriza la reapertura de vuelos en el pa√≠s excepto en Bol√≠var y T√°chira | #Nacionales |

https://t.co/OMcKAvu0qn",25634,73540,95236,194410
117,"Corte electricidad en zona de Negro Primero. Guacara. Edo. CARABOBO. Ya ni caf√© se puede preparar los Talibanes de .@Corpoelec_carabo se encargan del saboteo el√©ctrico. Buenos d√≠as Ministro
.@mppeeVzla .@NestorLReverol https://t.co/B1xrklVI9O",1169,81144,96353,178666
118,Desde un lugar del T√°chira le dicen: buen martes https://t.co/7A1j0L4hUs,36327,98597,51023,185947
119,"@betzabethguevar @PabloGuzmanDice @espaciopublico @churuguara Que cinicos! claro ustedes los enchufados cuando se enferman, van a las mejores clinicas y el pueblo? ese que utilizan como preservativo, es el que anda jodido y de paso tienen las santas bolas de mentirle en su cara. Descarados. Todos sabemos que la red hospitalaria es una cagad",45445,68661,20804,134910
120,"@defens_tachira con el fin de garantizar el debido derecho a la salud  como lo establece la CRBV realiz√≥  diversas visitas de inspecci√≥n a las Unidades de Hemodialisis a fin de  verificar la existencia de bicarbonato de sodio y atenci√≥n de pacientes. @Defensoria_Vzla 
@aruizddp https://t.co/ELMyS68k4J",2158,26350,33802,62310
121,"Trabajadores de Salud esperan ser vacunados este viernes o seguir√°n con manifestaciones
https://t.co/97WhIYjrkM
#PiedrasNegras #Vacunaci√≥n #Manifestaci√≥n https://t.co/i877SUEqzg",57516,57971,14537,130024
122,"La #GNBFalc√≥n, prestan Seguridad a las instalaciones de las plantas El√©ctricas en todo el territorio Falconiano #31Mar #FANB
#TodosContraElVirus
#GNByPuebloAlerta
#FANBEnDefensaDeLaDignidad .@NicolasMaduro .@cmdtegralgnb .@GNBGDjuvenal .@LopezvargasR https://t.co/fCiTCZJ6CO",44286,53147,94667,192100
123,"üò∑Cuidar del pueblo es nuestro m√°ximo compromiso en municipio Bejuma Edo. Carabobo garantizando cumplimiento de las medidas de bioseguridad #GNBGDPCmdte_Porlamar
#24Oct #VacunarseEsVida
#CEOFANBInvictosPorVzla
@PrensaCmdteGral
@Milicia_B1
@somos_ejercito https://t.co/Rghbp67x3g",904,52140,72531,125575
124,"#DATO | #AraguaFC le gan√≥ los dos partidos de local ante #CaraboboFC en la Temporada. 
---
En partidos entre ambos, los √∫ltimos 5 locales ganaron sus respectivos partidos. Desde el 2018 un visitante no gana en su serie particular. (Aragua 0-1 Carabobo) https://t.co/kiDUkeq6eu",14001,75821,60053,149875
125,¬øQu√© va a pasar con el d√≥lar paralelo esta semana? (+BCV) https://t.co/kfC5K6YQBS via @teleiguana,53270,41150,55435,149855
126,"@Luis_MontillaG @gustavo_febres @JHONNYPS @SeleVinotinto @Argentina Luz s√≠ mejor√≥ pero gasolina como que no jajajjajaj

En t√°chira si he le√≠do que lo de la gasolina ha mejorado",52049,353,87382,139784
127,Dabajuro espera informaci√≥n oficial sobre el Covid 19 https://t.co/uiw8TjzKHv,76980,46389,69618,192987
128,"#Clasificados #Producto #Servicio #Guarico #Trujillo #Miranda #Monagas #Bolivar #DeltaAmacuro  #Tachira #Cojedes #Aragua #Zulia #Caracas #Apure #Falc√≥n #Carabobo #NuevaEsparta #Barinas #Lara #Anzoategui #Merida #Portuguesa #Venezuela #Carabobonet
https://t.co/I0mM3uhxfV",20301,15226,60077,95604
129,Wilder Samuel Suniaga Guedez todos a votar! Fuera el chavismo corrupto.,2248,27028,59263,88539
130,"Docentes del T√°chira ser√°n vacunados contra el covid-19

https://t.co/NiurtfZzMF https://t.co/rwkcSqk3pY",57738,12417,75204,145359
131,"EN CARTAGENA LOS POLITIQUEROS YA PRENDIERON LOS MOTORES SUPONGO QUE @tripleCIbarguen SABE QUE EN BOLIVAR NO SACARA NI UN SOLO BOTO CIERTO?
RECUERDEN MI GENTE COJAN LA PLATA PERO VOTEN POR EL QUE SIEMPRE AH ESTADO EN LA LUCHA CON EL PUEBLO @GustavoBolivar @petrogustavo https://t.co/4q1g5K9JNJ",35847,32499,96928,165274
132,Wilmarys Abarca Descargas la  aplicaci√≥n bdv digital de la play store y all√≠ te dice abrir cuenta le das all√≠ y all√≠ te va diciendo debes tener a la mano tu Rif ya que debes escanear el c√≥digo QR Y tambi√©n tu c√©dula,55166,87406,80573,223145
133,"Hoy D√≠a los Comerciantes no est√°n tomando el Precio del D√≥lar ni el Paralelo ni el Del BCV , lo Tienen en 4.50 , ya aqu√≠ no es P√°gina alguna es lo q Dicen ellos , eso solo lo hacen x q no hay una Pol√≠tica q los ponga al Margen de la Ley , el Gobierno es Muy D√©bil ,,",38234,45699,37400,121333
134,"#FocoInformativo || Sucesos ‚û°Tres delincuentes muertos en rescate de comerciante secuestrado en Carlos Arvelo
#12Octubre #comerciante #policia #Carabobo #CarlosArvelo #delincuentes #secuestro #Venezuela #Sucesos 
https://t.co/zruXrlkYzQ",66269,29790,23836,119895
135,"2021-04-08 40mm en Jun√≠n, Buenos Aires, Argentina #pluviomano #gestionagro https://t.co/R7U8YEcI5p @caburearg https://t.co/6GjDz0qJ32",55381,84165,1543,141089
136,"@ungochoenvalenc IG: @MFalconia excelente iniciativa gracias.
Compras internacionales, importaciones, servicios de encomiendas, asesor√≠as y log√≠stica integral para compras en el extranjero. #coro #Falcon https://t.co/N82BBGjfKF",53111,8781,79138,141030
137,"#27Oct | El equipo del #MinComercio activos en #TRUJILLO, Mcpios
‚ñ∂Mcpio. Valera
para verificar precios concertados, medidas de bioseguridad, uso de la Tasa de BCV y la Ley de Metrologia
@CalidadEsVida
@DhelizAlvarez
@AnaponcePsuv
@mincomerciove
@ZODI23_TRUJILLO
@Rodomonsalve https://t.co/C8eBTmrqC5",25276,48845,12931,87052
138,@OscarRSports @FALCAO Copa libertadores 1991 en Miami y San Crist√≥bal Am√©rica vs Uni√≥n atl√©tico T√°chira,54479,10889,81320,146688
139,CUENTE CON LA POPULOSA PARROQUIA SAN JUAN HOMBRES Y MUJERES GUERREROS PARA LA BATALLA 21 DE NOVIEMBRE VENCEREMOS MI ALMIRANTE. VIVA SAN CARAJO ,80596,70074,76208,226878
140,"#Cr√≠menes | EN CARABOBO: Capturaron a seis sospechosos de tr√°fico infantil, planeaban llevar menores a Colombia  ‚≠ï https://t.co/Mjvd5AiqmK",77380,12127,15099,104606
141,"@unknxwnboy @JohanLozada26 @Huroncito29 Aqui toda la vida el pais ha vivido de la renta petrolera eso es lo que le daba fuerza al Bolivar, al bloquear PDVSA y dejar al pais sin ingreso de dolares e lbolivar no vale nada, fijate ahorita como esta entrando dinero el estado inyecta dolares a la economia y el dolar baja",47124,11502,58282,116908
142,"@HERNANGARBOZA @NASAEarth Vivo en Punto Fijo hacen 8 a√±os y me enamor√≥ esta tierra, pero este gobierno acab√≥  con eso, no entiendo como hay gente tas descerebrada que a√∫n culpa al imperio. #perdonatupueblose√±or",66920,64795,61791,193506
143,@HIDROFALCON Nuevo pueblo Sur para cuando cuerda de descarado,28834,33871,1871,64576
144,"La alfombra Roja y fiesta de gala para Bernal, el comunismo volver√° al Tachira de manera formal, que triste ver a mi tierra tan hermosa otra vez en manos de comunistas, solo por el ego de no aceptar que hay candidaturas mejores y que ser√≠an m√°s beneficiosas que el PSUV https://t.co/7A2pVjVLJl",1244,8152,57204,66600
145,"Ya la OIM esta ""condicionando"" a nuestra poblaci√≥n para el Plan de Refugiados que nos van a imponer, ante la indiferente y d√©bil conducta del presidente y su gobierno. Tenemos que reaccionar ante este hecho tan tr√°gico como fatal. Ning√∫n presidente antes acept√≥ esto. https://t.co/SQKYal4yGe",42769,75708,81916,200393
146,@NOTIFALCON Unos  cuantos comen,73982,93581,89792,257355
147,"@laidygomezf Mujer de frente amplia.
 Acumula m√°s ideas.",14751,97613,79070,191434
148,@pabloaure Pr√≥ximo Gobernador del Estado Carabobo en Democracia  una de las  Mente Brillante  de VENEZUELA  Bendiciones  profesor,31403,10380,86340,128123
149,"Disfruta la diversi√≥n de aprender a bailar Salsa Casino junto a la tropa del @MPV_Tachira. #TropaPazYVida 
#DesplieguePorLluvias https://t.co/j9xNLIpdaD",73578,3133,43181,119892
150,#Caracas | Vendedores ambulantes de comida por $1 en Sabana Grande cotizan la moneda estadounidense en Bs. 5 o Bs. 5.000.00 soberanos. Conoce la variaci√≥n en la tasa en el siguiente enlace https://t.co/CuD8rwVKoY,25239,90036,96040,211315
151,"#culturatachira Virgen de la Chiquinquir√°, venerada en el edo. Zulia-Venezuela.
Exposici√≥n individual y virtual ""Llena eres de Gracia"", de Desir√©e Gonz√°lez Zerpa.
Muestra art√≠stica organizada por el Museo del T√°chira de la @DCETachira.
Obra: ""¬°Mami, qu√© rico est√° el cepillado!"". https://t.co/jJRxQoSpjz",20375,48499,12723,81597
152,"@FreddyBernal
 @NicolasMaduro Sr Presidente El personal M√©dico, Empleado, Administrativo, Obrero Y Asistencial  adscrito a la Corporaci√≥n de Salud del Estado Tachira solicitamos nos sea cancelado la Homologaci√≥n de los meses de Mayo,Junio y Julio del a√±o 2021 .",24047,47040,8191,79278
153,#NACIONALES Guaid√≥: pago del plan Covax es fruto de la presi√≥n a Maduro https://t.co/evIPygDXuo,35609,19428,27855,82892
154,#ESPECT√ÅCULOS Miss Zulia 2008 cuenta sus vivencias en la c√°rcel tras relacionarse con narcotraficante colombiano https://t.co/Zr6RMHPNKF,72707,91127,28600,192434
155,"@PresidencialVen Sr. Presidente de la Rep√∫blica, el equipo de trabajo del sector salud en T√°chira, luchamos incansablemente por la operatividad en las √°reas administrativas y asistenciales. Por ende, solicitamos la aprobaci√≥n de recursos: pago HOMOLOGACION ACTA CONVENIO desde may",57719,93580,46257,197556
156,"Amen y Amen en El Cobre, Tachira, Venezuela https://t.co/GEMnkZYU2q",49458,76181,38649,164288
157,No sea rata vernal . Esas partidas le tocan por ley a la gobernaci√≥n . Y ustedes se la roban . Por qu√© no act√∫an bien como la ley manda. Vernal y maduro y toda su Canad√° de raras . Porque no hacen lo mejor para el pa√≠s. Renuncien . Dejen el miedo de en‚Ä¶ Ver m√°s,63397,68494,11635,143526
158,"Nuestra moneda sera fuerte el dia en que los venezolanos entendamos que la economia se debe respetar quien da la ordenes, BCV recuperando autonomia #IndexacionSalarialYa  #DebateIndexaci√≥nEnAN #13Oct @NicolasMaduro @jorgerpsuv @tonyboza",13415,66455,90809,170679
159,"@omargp84 Y si tienes que renovar o se te perdi√≥ la tarjeta de d√©bito, para darte una nueva te piden hasta la partida de defunci√≥n de tu √°rbol geneal√≥gico completo @Banesco",79069,73189,27881,180139
160,#1Nov || BCV suspendi√≥ otorgamiento de permisos para operaciones como Proveedor no Bancario de Servicios de Pago https://t.co/OYOhRzw25g,98473,81287,57370,237130
161,#Sucesos Abatidos 3 secuestradores en el estado Carabobo https://t.co/PgTXg0qG36 https://t.co/XXGIuIrtET,37879,59489,30666,128034
162,#NACIONALES El pasaporte venezolano entre los m√°s caros de Am√©rica https://t.co/9iPUqR2NRQ,81182,41759,75734,198675
163,"@Eliecersangroni @m_estiben @maderoluis @marrpacheco @alves_guillen @burro_hipico #Hipismo #LaRinconada @GonzaloSangron5 
HOY JUEVES 26 08 21
085 y 068 TACHIRA Y TRIPLE CALIENTE MUCHA SUERTE VENEZUELA",80860,97700,73585,252145
164,@Banesco Buenas tardes despu√©s de la reconversi√≥n no funciona mi pago m√≥vil. Intent√© entonces con transferencia inmediata a otros bancos. A√∫n espero que sea ejecutada. @Banesco agradezco respuesta.,63957,72804,92956,229717
165,"#INTERNACIONALES Papa Francisco hace un llamado para que vacunaci√≥n contra el coronavirus sea un ""bien com√∫n universal"" https://t.co/3AKMNekFl7",50606,68457,7201,126264
166,"DAD GRACIAS A DIOS...

üå∏üåø

#ClasesVirtuales #ClasesPresenciales #IBAO #AlfaYOmega #PiedrasNegras #Coahuila #M√©xico
#YoEstudioParaPastor
#YoEstudioParaProfeta #YoEstudioParaEvangelista #YoEstudioParaMaestro
#YoEstudioParaAp√≥stol https://t.co/laP6RdzeZ6",76693,18402,34501,129596
167,"@VCammarano @dydan17 @NuevaTec47 @ENZOSCARANO ninguno, lamentablemente Carabobo seguir√° siendo Ciudad Ca√≥tica con ü¶á y as√≠ pasara con muchas gobernaciones producto de malas estrategias y campa√±as vomitivas de la MUD que no aprovecharon el malestar de los votantes sino que est√°n dando otro show",77594,59592,84871,222057
168,"#GNBFalc√≥n, prestan Seguridad a las instalaciones de las plantas El√©ctricas en todo el territorio Falconiano.
#30Mar #FANB
#SputnikVContraCovid
#GNByPuebloEnVictoria
#FANBEnDefensaDeLaDignidad .@NicolasMaduro .@cmdtegralgnb .@GNBGDjuvenal .@LopezvargasR
https://t.co/HSG3rIiu1s",79119,32669,86864,198652
169,"@fischlb0t @3NVYB0T Estuvo a punto de quedar dormido hasta que escuch√≥ el sonido de un mensaje, se forz√≥ a seguir despierto y caminar hacia la entrada para poder abrirles. Ni si quiera se fij√≥ en la apariencia que ten√≠a y abri√≥. ‚Äî Hola, perdonen las molestias... ‚Äî Dijo ocult√°ndose un poco por miedo.",51934,78101,91292,221327
170,"Solo pocos comercios usan el d√≥lar a la tasa de BCV. 
Si de verdad el SUNDEE los va a cerrar y multar entonces ser√° al 90% de todo los comercios",99105,21194,95924,216223
171,"@rafaellacava10 Agua. ""NO HAY"" Pero si van a la casa de Gobierno all√≠ si. Eso es puro cuento el Edo. Carabobo est√° abandonado, sin agua, sin medicinas, sin luz, osea los servicios p√∫blicos no sirven. La Salud no sirve. Aqu√≠ nada sirve.",42996,98334,91805,233135
172,"@SudebanInforma @BCV_ORG_VE Favor tomen cartas sobre el asunto para el Banco OCCIDENTAL de Descuento (BOD) desde hace m√°s de un mes no realiza pago m√≥vil, y devuelven las transferencias hacia otros bancos. Tienen un corral financiero con los clientes dejando su dinero √∫nicamente en el Banco. #BODSOS",12852,68684,19803,101339
173,"Podrido sistema de justicia el que tenemos, no s√≥lo hay que derogar la JEP, tantas cortes bur√≥cratas al servicio del hampa organizada. https://t.co/roqfSC7LQ2",11888,40922,53935,106745
174,"#Politica - Maduro: Estamos en la tercera ola, Caracas, Miranda, La Guaira y Carabobo

#5Oct 
#NicolasMaduro  
#Carcas 
#Miranda 
#PortaldeNoticias 

https://t.co/qybJNaHhRA",42236,16071,84774,143081
175,@Ignaciozh_r @robertomalaver Te falto mandar a boicotear la p√°gina del $ criminal del @BCV_ORG_VE,54523,4482,767,59772
176,@CorpoelecCarabo @Banesco Pedazos de mierda como pretenden que uno pague un servicio que no sirve para un co√±o e la madre y menos aplicando este sistema tan ineficiente como ustedes cuerda de mediocres,17902,32327,38831,89060
177,Gobernador @OmarPrietoGob destac√≥ en #OmarALas7:A trav√©s del Plan Carabobo 200 hoy se practicar√°n 55 Cirug√≠as   #VenezuelaTieneConQu√© https://t.co/2aIb079fSm,26704,46654,38711,112069
178,"FYI: Enciclop√©dia das L√≠nguas Arawak, acrescida de seis novas l√≠nguas e dois bancos de dados: The eminent Brazilian linguist of French origin, Henri RAMIREZ, published a new comprehensive book on Arawakan languages. It is Enciclop√©dia das L√≠nguas Arawak,‚Ä¶ https://t.co/uC8PSyjMGC",66647,12260,50979,129886
179,"Efectivos de la #GNBFalc√≥n efectuar√≥n la detenci√≥n de 01 Cddno por el delito de robo, a quien se le Incaut√≥ un tel√©fono celular. #17Abr #FANB #GNB
#DaleUnParaoALaCovid
#GNByPuebloUnido
.@NicolasMaduro 
.@cmdtegralgnb
.@GNBGDjuvenal
.@LopezvargasR #GNBFalc√≥n https://t.co/9JW17InYID",37829,69228,51271,158328
180,"#repost @lbabaloncesto
„Éª„Éª„Éª
üîπ Escenario Listoüîπ

La Cancha del Centro Social Madeirense lista para recibir la sexta jornada de la LBA.

#SelloDeCalidadLBA #LigaDeBaloncesto #Asocenca #UnidosPorElBasket #Baloncesto #Interclubes #Carabobo #LBA https://t.co/yNzD7x5EIz",65114,71871,39776,176761
181,Roguemos al se√±or Am√©n,49205,59266,22034,130505
182,@BCV_ORG_VE @SudebanInforma Ustedes est√°n como dolar paralelo suben todo el tiempo y los comerciantes gozando porque el d√≥lar sube para seguir j******* al trabajador y al pueblo,46661,52951,85145,184757
183,Acaba de publicar una foto en Carabobo https://t.co/QgRT3a6uY7,90918,37291,43451,171660
184,"El mantenimiento de nuestros espacios verdes es una de las principales tareas que realiza diariamente el personal de Parques y Jardines. Hoy continuamos embelleciendo:

üå≥Liga La Floresta (Calle Pablo del Solar)
üå≥Liga I√±aquito
üå≥Las Manuelas (Calle el Pedregal) https://t.co/Ahm1R2JLg7",31863,75057,15064,121984
185,"#Ent√©rateüìå | El tipo de cambio publicado por el BCV es el promedio ponderado de las operaciones de las mesas de cambio de las instituciones bancarias. 

Precio del d√≥lar 11/10/21: 4,16410000

#MercadoCambiario https://t.co/ej2XwKX68i",80754,88818,84061,253633
186,"üöñüëâüöòüëâüöôüëâüöóüëâüöï
AUTO PARTS AGELVIS LIBERTAD
üì£üì£üì£üì£üì£üì£ 
#PRONTO GRAN #INAUGURACI√ìN
PRONTO GRAN INAUGURACI√ìN
PRONTO GRAN INAUGURACI√ìN
üö®üö®üö®
EN CAPACHO LIBERTAD
‚¨áÔ∏è‚¨áÔ∏è‚¨áÔ∏è‚¨áÔ∏è
AUTO PARTS AGELVIS LIBERTAD
#capachoindependencia #capacholibertad #sanantoniodeltachira #Tachira https://t.co/2dkI8t3G93",97769,57797,45163,200729
187,#Falc√≥n - Instalado transformador de potencia en subestaci√≥n el√©ctrica Carirubana https://t.co/xq8oMaSCpA,65347,17885,85160,168392
188,Tachira: Cantv culmin√≥ labores de optimizaci√≥n en la central¬†andina https://t.co/sP3c6ALr0t,32599,31039,98967,162605
189,#Carabobo | M√©dicos Milton Quintero y Yoglan Madriz murieron por COVID-19 https://t.co/2f7zpX8Qe4 .-,23985,14645,35765,74395
190,"#Ent√©rate Ministerio de Comercio Nacional pone a disposici√≥n los siguientes n√∫meros telef√≥nicos para que se denuncie la especulaci√≥n por parte de comerciantes que usen tasas superiores a las del #BCV para cobro en divisas convertiblesüáªüá™ 

#ChavismoVictoriaPerfecta https://t.co/hbZBgn6Z9O",92479,5222,39999,137700
191,@CDominguesP  Una pregunta si tuviera que  escojer a qu√© partido asistir√≠a? T√°chira Caracas? T√°chira Estudiantes?  Estudiantes Caracas?,27395,15512,3642,46549
192,Daniel_RiosVE: Familia de Elijah McClain llega a acuerdo con ciudad de Colorado por incidente policial https://t.co/P4ZxtEAziS #DanielRiosTeInforma #Valencia #Carabobo #Venezuela,73642,45178,71650,190470
193,As√≠ llega el agua a Naguanagua Edo. Carabobo. üò≠ https://t.co/x5lBHcifzS,31167,68859,23997,124023
194,@Naldoxx esas inyecciones del bcv ya no hacen efecto amiguito,76144,57081,99910,233135
195,"#Mujeres dispuestas para cada ocasi√≥nüë†Encuentra tu #escort favorita en el cat√°logo virtualüîù y #agenda tu #cita
+584129612616üì≤
https://t.co/MKuOYGg65Müíª

#act
#Caracas #Valencia #Barquisimeto #Tachira #Venezuela #chicasmalas #damadecompania #nacional #SABADODELUXE #findesemana https://t.co/KwiBOcTtiA",84650,15034,28015,127699
196,"A pesar de que muchas de las decisiones no nos gusten debemos seguir adelante, Soy un hombre que tome una decisi√≥n de vida y fue defender profundamente a mi pa√≠s no voy a claudicar ni un segundo este ideal, mi compromiso es con el Tachira y mi querido Cardenas !",16756,29657,99765,146178
197,saludos @ajcaleca y toda esa linda familia aqui en el tachira son fuertes los bajonazos no se va pero queda como un fosforito esto va por el camino de zacatecas buen apetito DIOS los proteja cuide a toda es lindura familiar feliz tarde https://t.co/N9xfa5K0Kc,91328,565,27412,119305
198,@ENZOSCARANO @ENZOSCARANO mire @rafaellacava10 le ha echado pich√≥n a todos los problemas de Carabobo y usted sencillamente no sabe c√≥mo atacarlo y de inventa situaciones que los carabobe√±os no las creemos...usted no va PAL baile... jajajaja... arriba Dr√°cula...,4937,63990,36518,105445
199,"Y desde ac√° desde el municipio al que hidrocentro le quit√≥ el agua y cambi√≥ el nombre a NN, llevamos cinco d√≠as igual que la gran Valencia. 

Medio estado Carabobo sin agua y si no fuera por el Cordonazo de San Francisco llevara ya cuatro d√≠as sin ba√±arme... https://t.co/ojIic9F9ZH",44990,40137,99526,184653
200,"@DiarioPrimicia Todas las comunidades en el Estado Bolivar estamos en las mismas condiciones, Sin servicio de Agua, y sin ning√∫n planteamiento serio en relaci√≥n a la situaci√≥n, habr√° q plantearse una marcha general, denuncia ante la fiscal√≠a.",58363,30111,30869,119343
201,"üîú ùó°ùó¢ùó©ùóúùóòùó†ùóïùó•ùóò üíõ
üîú ùó°ùó¢ùó©ùóúùóòùó†ùóïùó•ùóò üß°

Muy pronto en el mes de Noviembre prep√°rate para vivir una experiencia de otro nivel
 
#spa #relax #instagood #beautiful  #men #boy #pride #Caracas #gay #Carabobo #Valencia  #SanDiego #Apertura #Venezuela https://t.co/23loarN0lw",86541,57020,69776,213337
202,"Saab anuncia captura de ""Chiche Smith"", se√±alado de liderar el ""Cartel de Paraguan√°"" [+Tuit] https://t.co/ODlsJdlWkc",83071,64728,38190,185989
203,Daniel_RiosVE: Tiroteo en Atlanta deja dos muertos https://t.co/XEPP5m1iaQ #DanielRiosTeInforma #GacetaCarabobo #Carabobo #Venezuela,70994,20306,99088,190388
204,"El Verdugo @NicolasMaduro clama por sus V√≠ctimas. Despu√©s de Destruir la Econom√≠a, Pulverizar el Bolivar, Quebrar las Empresas b√°sicas de Petr√≥leo, Gas, Electricidad, Hierro, Controlar Todos los Poderes del Estado, Tr√°ficar Coca√≠na, Asesinar Opositores etc. , ahora se Conmueve.",7037,6504,10610,24151
205,@NicolasMaduro o 3 estaciones de servicio a precio subsidiado son las que trabajan... y a 50 carros es a lo que atienden!!! hay problemas con la gasolina pero a precio Subsidiada porque la internacional  ni colas hay,89403,75108,73868,238379
206,"Al menos hab√≠a silencio, cosa que agradec√≠a. 

La mirada ha alzado del libro a la sala. Esta, vac√≠a, termin√≥ por perderse en un punto fijo dado que hall√≥ la presencia de un alma conocida. 

La cubierta del libro acarici√≥, sonriendo por un segundo antes de cerrar los ojos.",42651,63822,72628,179101
207,"V√≠a @ReverolNestor 

Desde el coraz√≥n energ√©tico de la patria, nuestro Complejo Hidroel√©ctrico del Bajo Caron√≠ en el estado Bol√≠var, continuamos con el despliegue nacional de la #VicepresidenciaDeServicios https://t.co/eFkPFtsKXA",947,52659,64433,118039
208,"#Sucesos | Incautaron 28 toneladas de material ferroso en el estado Bol√≠var
https://t.co/CzTOsF6VOH",11080,76675,55285,143040
209,Buen d√≠a se√±ores del @BcodeVenezuela ¬øPueden por favor indicar por qu√© no se puede hacer transferencia ni pago m√≥vil a otros bancos desde el celular o el usuario de Internet? Gracias,7412,69016,31005,107433
210,"#Carabobo @rafaellacava10 se consigue gas la bombona de 10klg la est√°n vendiendo en 10 $ cada d√≠a hay mas corrupci√≥n en los llenaderos h√°gase una encuesta y preg√∫ntele a las personas que venden perro caliente a que precio la compran,maiquet√≠a,plaza venezuela,Docentes,Cantv https://t.co/05I8jHmwwQ",17055,68300,17687,103042
211,"@roshernandez @laidygomezf Pero por ahora Ceballos no se mide en la internas, est√° impedido. La gente tiene un nivel de confusi√≥n alto, porque la oposici√≥n tiene dos frentes pol√≠ticos con cara al 21 de noviembre en T√°chira. No han logrado unidad",85881,26626,30532,143039
212,"Viernes Santo. Dios Permite Todo, adem√°s hoy 02 de Abril son 54 a√±os que sigue dormida la Beata Madre Maria de San Jos√© siendo ese puente de comunicaci√≥n con Pap√° Dios. 
@NoticiasFalcon https://t.co/8XblckPYlp",88213,53609,23832,165654
213,"BDV sigan peg√°ndose al gobierno que van a tener el mismo destino, EL RECHAZO.",94352,95578,92885,282815
214,Acaba de publicar una foto en Puerto Piritu Edo. Anzuateg√ºi https://t.co/lyTHnlnQlF,82070,26666,4342,113078
215,"‚úîÔ∏è#9Oct Farmayor, ubicada en la Urb. El Para√≠so, fue fiscalizada este s√°bado por autoridades del ministerio de Comercio Nacional, para verificar tasa cambiar√≠a oficial del BCV y cumplimiento de precios acordadosüáªüá™ https://t.co/K3KYSXZfwG",8881,39680,35595,84156
216,"Viv√≠ en el Zulia; en Falc√≥n; en Carabobo y ahora en Anzo√°tegui, y creo que cada regi√≥n es como la tierra donde fluye leche y miel. Es por f√©, no por vista üôèüèΩ. Amo a mi Venezuela üáªüá™‚ù§ pero creo que Dios nos bendice en cualquier lugar que estemos üôèüèΩü§ó",88006,4515,44899,137420
217,@SudebanInforma @BCV_ORG_VE @jaarreaza @dcabellor Quien ser√° el presidente de la Casa de la Moneda? Realmente es chavista solidario revolucionario y no piensa en como se presta para la tracaleria en el Pueblo las confusiones https://t.co/vaSigCxuje,26283,21753,53863,101899
218,@vasconcellosed @BcoBicentenario @BcodeVenezuela @miguelperezabad Que Shit.... es que ni el pago m√≥vil sirve todav√≠a.... que perdici√≥n de Banco... no quiero ni transferir dinero para all√° porque no s√© si en el camino se pierdan esos reales y nunca lleguen a su lugar. As√≠ qu√©... lo siento! Ll√°meme cuando se haya resuelto todo. De resto bye bye!,91278,54002,42343,187623
219,"@EvelynBVasquez üîµ#03Oct | #Domingo  #AHORA 03:51 pm OTRA VEZ #SinAgua en #LaIsabelica, #Valencia #Carabobo 
¬øY el #Agua pa cuando?
¬øC√≥mo vamos a prevenir?
#VacunateSinCita
#Covid_19
El racionamiento es Martes y Viernes
#ATENCI√ìN
.@Hidrocentro2011
.@MPPAAguas
.@rafaellacava10 
.@EvelynBVasquez",80810,89425,62216,232451
220,"@rmfinanzas @BcodeVenezuela AQU√ç TIENE UN AYUDANTE QUE LE HARA LLEGAR LA DENUNCIA,RESPECTIVA, CUANDO AS√ç LO REQUIERA LA SITUACI√ìN üí• QUE TENGA UNA EXCELENTE Y SALUDABLE GESTI√ìN üí•‚ùó CON PERSEVERANCIA Y PACIENCIA SE LOGRA LA VICTORIA, PORQUE ELLAS SON LA ABUELA Y LA MADRE DE LA VICTORIA üî•",46480,85053,19200,150733
221,Drac observando al nuevo inquilino de quinta Carabobo. Jajajaja https://t.co/F9XiAxLokw,21908,28524,71172,121604
222,En lago se puede llegar de Xochimilco al Centro. Existi√≥ la ciudad de la cultura sobre Pedregal de Santo Domingo. El norte industrial se volvieron lofts reales y casas tipo la de Bofill. Nos llamamos M√©xico a secas y el pa√≠s tiene su propio nombre sin usar el nuestro.,62162,18899,54449,135510
223,"#CentinelasGarantesDePaz Desde el estado Bol√≠var nos preparamos para contin√∫ar nuestra gran labor al servicio de la Naci√≥n

#25Sep #CEOFANB #GNBBol√≠var 
#GNBPacPaluaBolivar
#LasSancionesSonUnCrimen
.@PresidencialVen
.@PrensaCmdteGral
.@GNB_CZBolivar https://t.co/0wzbVzrSi6",96868,80197,23447,200512
224,@BcodeVenezuela Debieron advertirnos del robo descardo que hicieron uds...se acuerdan el de septiembre.,77789,89716,66576,234081
225,¬°SEPA! BCV sigui√≥ inyectando divisas por segundo d√≠a seguido: D√≥lar oficial subi√≥ mientras el paralelo se derrumba (+Datos) https://t.co/RmETrjBvzR,15765,92335,23582,131682
226,@MayaEnBici @ChapultepecCDMX Asi estan todos los jardines de la cuidad MENOS los camellones de Jardines del Pedregal..Dato veridico.,8563,95424,79469,183456
227,El Carabobo que no quieren que se vea. @ENZOSCARANO es garant√≠a de cambio. https://t.co/mswp1g7MOH,40780,83508,97557,221845
228,"Construir El Estado Comunal es una necesidad impostergable, cumplase!!! @NicolasMaduro
@NorisHerrerar @tachira_comunas
@Mp_Comunas #Propuestas LEY ORG√ÅNICA DEL PARLAMENTO COMUNAL NACIONAL #PCN Comuna UNI√ìN SOCIALISTA 
COMUNA O NADA!!! @comunabuenvivir https://t.co/8lKnHUGPnP",11456,33124,76132,120712
229,#NACIONALES Venezuela recibe lote de la vacuna rusa EpiVacCorona https://t.co/lOeed83Soi,88053,85339,87587,260979
230,"#Fedeindustria Carabobo: encaje legal frena al sector productivo - Los pocos financiamientos solicitados no son entregados a tiempo; pues no hay liquidez para abarcar las sumas solicitadas.
 - https://t.co/P0PQgcVtXV

#EncajeLegal #EscasezDeEfectivo #SectorProductivo",24981,81220,40067,146268
231,"@MarioBuffoneL @eliaspino @hramosallup @prospericarlos @frarchila @igorwilliams @CarluchoOJEDA @thstraka @GTAveledo @rafaelarraiz @RLOZINSKI Hoy Falc√≥n tiene: el isiro,barrancas,hueque,maticora,el cristo y dos mas q olvido,todas obras de AD y COPEY,todas arruinadas por chavez,no hay una calle en Falc√≥n q tenga agua por tuber√≠a,eso es terrorismo de estado.",67361,610,41843,109814
232,"@garciabanchs El problema no el nombre del Bolivar el problema es la autonom√≠a que debe tener BCV, quit√©mosle a los pol√≠ticos la conducci√≥n de los dineros p√∫blico, todo se origin√≥ con el millardito de Ch√°vez",94136,22772,96034,212942
233,"#LaNuevaAlternativa
#YoVotoPCVGalloRojo
#indexacioneslavia 
#YoVoyAMiGalloPinto
@RicardoAdrianD Gobernador De Carabobo
@luisapinto_21 Alcaldesa De San Joaquin 
@PCV_Carabobo
@OscarFigueraPCV @jcarrillo409 @APRsanjoaquin61 @WalterDossier @ppt_uzcategui https://t.co/ATFPxGVg8X",73247,37112,50832,161191
234,"Mi gente ayudemos a Jorwin y su novia que lo necesitan en estos momentos.

Dios se los multiplique! 

#covid #valencia #reserve #carabobo #venezuela #binance https://t.co/pI1D2pF0wp",64427,65777,25771,155975
235,"#PiedrasNegras En el municipio de Guerrero no tienen una fecha espec√≠fica para poder programar la segunda campa√±a de vacunaci√≥n contra el Covid.
https://t.co/oqZ5YNS7sZ https://t.co/inlcqXvPUo",71245,56976,75226,203447
236,"@TuAccesoTotal Kit Nintendo Dsi por 2$, incluye: 01 Lector de Tarjeta MicroSD, 03 Protector de Pantalla y 03 L√°pices punta de goma. #Nintendo #DSI #Game #Vende #VenVariedades #Carabobo #Valencia #SanDiego #mercadolibre https://t.co/HtqYnDG67t https://t.co/24DKS64vkM",82270,40203,222,122695
237,"#6Oct 

¬°MEGA DEVALUACI√ìN! Lo que viene si el BCV se empe√±a en intervenir en el mercado cambiario

https://t.co/HAKhmB2LLw",86692,81973,20078,188743
238,Autor√Ångelly Franquines Continuamos las labores internas para solventar los inconvenientes que presenta nuestra plataforma. Reiteramos nuestras disculpas.,77765,32992,56964,167721
239,"La Zona Educativa del Estado Bol√≠var, contribuye con la difusi√≥n de la medidas preventivas paran aplanar la curva de contagios del Covid-19 en el inicio de clases presenciales.
#VenezuelaTieneconQue https://t.co/AeUQbqREKx",13350,8668,54173,76191
240,Igualmente est√° ca√≠da la plataforma desde ayer,93167,31745,45259,170171
241,"AutorYogen Sol√≠s Nos sensibilizamos ante lo ocurrido con tus compromisos de pago y recibimiento de dinero, progresivamente tomaremos tus reclamos para solucionar a la brevedad posible.",61890,4351,76996,143237
242,"Hoy la cita es 10:00am en Reporte  Bernal por 94.5fm 
@YvkeTachira con el proximo gobernador @FreddyBernal y la mejor informaci√≥n para el bienestar del pueblo del T√°chira, en lo social, salud, alimentaci√≥n y pol√≠tica 
@BermudezJoseA
@Juntosxtachira1
@ClapParroquia
 @tachira_gmas https://t.co/fRvVNbIaGt",93135,55778,1681,150594
243,@delgis1803 Si muere y la creman el incendio que causar√° todo ese silic√≥n har√° parecer a tacoa o Amuay unas fogatas,87534,14177,89381,191092
244,@dbv_e @zorione21 @SergioVigu @Angelluzpzo @Lezmirbrham1 @857delta @ArquimedesGm @gonzalolezama1 Buen sia amiga bella grupo amado Abrazos y Bendiciones dese√°ndoles el mejor d√≠a posible con Dios y un rico caf√© #Agradeciendo  leerles hoy todavia hay internet ü§™üò≥üòÇüòÇüòÇüí™üçÄü§ó en mi tienda favorita #TheCu√±aosMarket  si en Puerto Piritu gentilmente me atienden y son mis amigos üëç https://t.co/bjI87PR1ON,60961,885,35005,96851
245,@BcodeVenezuela Este banco son unos ladrones,95767,53309,17469,166545
246,"El golpe de oferta de $ del BCV rindi√≥ alg√∫n fruto... al menos para recordar el 4,30 Bs/$.",98050,40459,93484,231993
247,"@panita__pana @paolandia77 @EloinFirenze @pilargiri Ah√≠, en Carabobo entre las cuadras de Zuvir√≠a y Saraza hay varios incluso supermercado, tambi√©n hay algunos en calles internas pero son los menos (incluso algunos de esos son cerrados a la comunidad).",43269,13533,24494,81296
248,"D√≥lar en Venezuela
1 de noviembre | 9:00 am

Altibajo en consideraci√≥n a la publicaci√≥n anterior:

üí∞Monitor D√≥lar: Bs. 4,50
üí∞D√≥lar Today: Bs. 4,45
üí∞BCV: Bs. 4,37

Jhorman Cruz ‚Ä¢ En Noticias
Telegram ¬ª
https://t.co/H2XJEdZ2KK
Canal v√≠a WhatsApp ¬ª
https://t.co/sXbXIljaBh",15654,52323,48450,116427
249,"@JcpereiraCantv Cu√°ndo llegar√° la fibra √≥ptica de cantv ac√° en Punto Fijo, Estado FALC√ìN. La GPON es la soluci√≥n a la aver√≠a masiva de 5 a√±os en el Sector Nuevo Pueblo NORTE. M√°s de 300 suscriptores con aver√≠a masiva, por robo de cable de 300 pares.",5639,72692,77673,156004
250,BCV baja presi√≥n a la banca por no vender a tiempo divisas inyectadas al mercado oficial https://t.co/UOOJEtFpVf https://t.co/A3WOdSUn5q,43882,10846,35731,90459
251,"Monta√±a (Andina): Dub√°n Bobadilla (Herrera Team)

Sprints especiales (Talentos Colombia): Steven Cuesta (Sundark Arawak)

L√≠der sub-23 (Alcald√≠a de Bogot√°): Rafael Pineda (Colnago CM Team)

Mejor novato (ManzanaPostobon): Carlos Romero (N√©ctar Cundinamarca)

Fotos: @edergarces7 https://t.co/CsCAUxiOns",11649,19262,32024,62935
252,"@salasrluis76 No pueden sugestionar tu compra, y si Luis as√≠ est√°n haciendo usan el valor del d√≥lar del bcv a conveniencia, ayer tuve la oportunidad de comprar unos medicamentos en una farmacia, si pagas en divisas y no tienen vuelvo en divisas pr√°cticamente debes usar el billete completo.",19131,13092,38623,70846
253,"@Mippcivzla @EneidaLayaPsuv @almacaracas @luis_villegasr @Inpsasel_vzla @MinEcoFinanzas @delcyrodriguezv @SENIAT_Oficial @sundde_ve @delcyrodriguezv por favor env√≠en a mas tardar hoy supervisores a petare. los chinos y dem√°s colocan el valor del $ por el punto d venta desde 5,2 5,5 5,7   muy por encima del BCV. OBLIGARLOS A COLOCAR CARTELES CON EL LOGO del BCV EN CADA CAJA REGITRADORA LA TAZA DEL del dia SOS",53511,66933,17670,138114
254,"@PartidoPSUV Buenos d√≠as camaradas haci c√≥mo le han dado ministerios a precandidato a la gobernaci√≥n que no ganaron las internas necesitamos que contenten al pueblo del tachira y le den un ministerio al camarada LEONARDO SALCEDO ""Venceremos""",36589,11415,55370,103374
255,"@intelig67076526 @MILICIAFALCON1 @arichacan ADI. 124 ARICHACA
APDI. Parroquia Tucacas municipio Silva
Soldados de esta gloriosa revoluci√≥n seguiremos rodilla en tierra unidad lucha y batalla
Venceremos",85339,84489,52126,221954
256,"#NotiMinAguas üóûÔ∏è | Pueblo Trabajador del Agua de @Hidrocentro2011 repar√≥ fuga de agua potable a trav√©s de la sustituci√≥n de 4 mts lineales de tuber√≠a de 12"" en la autopista Sorpresa Muelles, beneficiando a m√°s de 5 mil habitantes del mcpio. Puerto Cabello, edo. #Carabobo https://t.co/iBSEGl9Zw7",55929,55475,88729,200133
257,"La #GNBFalc√≥n realiz√≥ Despliegue con el fin de garantizar el cumplimiento de las medidas de Bioseguridad. 
#31Mar #FANB #GNBApure
#TodosContraElVirus
#GNByPuebloAlerta
#FANBEnDefensaDeLaDignidad 
.@NicolasMaduro 
.@cmdtegralgnb
.@GNBGDjuvenal
@LopezvargasR https://t.co/Q7fUQndVp0",53521,52187,58101,163809
258,"Dos de los equipos que mejor f√∫tbol brindaron durante todo el torneo se quedan afuera en la √∫ltima fecha. As√≠ de impredecible es este deporte. Carabobo y Gran Valencia, demostraron que se puede ir a buscar los partidos en cualquier campo. El f√∫tbol ya les dar√° su revancha.",29972,36453,75485,141910
259,"El personal del gremio de Educaci√≥n del estado T√°chira, se ha vacunado contra el covid, por medio del Sistema Patria y del Operativo adelantado por la Zona Educativa. Actualmente se atienden diversos municipios.

@_LaAvanzadora 
@MervinMaldonad0 
@charlychaves 
@FreddyBernal",12214,35829,73397,121440
260,"Sin servicio de voz ni datos trayecto #Chichiriviche #Tocuyo #Sanjuandeloscayos motivo desconocido.
@salaprensaCantv @arepatecnologia
Ca√≠do #Cantv en toda esa zona.",17317,76823,84388,178528
261,@GNBCmdtGral @GNB41_CARABOBO @Rivera_bastardo @gnb_paceltoro  venceremos,71190,38124,79150,188464
262,"#20Agos #Tachira Desde el Municipio Ayacuho se desarrolla Jornada de Mantenimiento Preventivo continuando con el plan de Escuelas Abiertas en Agosto Bicentenario
@MPPEDUCACION
 @yelitzePSUV_
@ZonaEducTachira
 @charlychaves
 @Juntosxtachira1
@FreddyBernal https://t.co/OFonae1NVr",45967,16197,69139,131303
263,"Para rechazar negativa del Gobierno Nacional en la firma Del acta convenio que reivindique a trabajadores de la salud, ayer mi√©rcoles, agremiados a SIRTRASALUD #Falc√≥n realizaron protestas en dependencias administrativas de los diferentes centros asistenciales del estado. https://t.co/HN5aEIiQOa",65271,2390,35707,103368
264,El #Psuv en T√°chira inscribi√≥ los candidatos a las 29 alcald√≠as y a la gobernaci√≥n @FreddyBernal en un acto respaldado por la militancia chavista.Rumbo al #21Nov https://t.co/g48jRfSIiy,82923,71252,299,154474
265,"Carabobo Te Quiero realiz√≥ jornada de saneamiento intensivo en C.D.I. La Manguita

#VacunarseDependeDeTi

https://t.co/HlimQq6R5G https://t.co/3hLkpKUZr1",26824,77476,30542,134842
266,Hola. C√≥mo hago para actualizar el n√∫mero de tel√©fono sin ir al banco? ,18751,35392,42874,97017
267,"#ENT√âRATEüì£| El #28Oct inicia el XV Festival Mundial de Poes√≠a de Venezuela üáªüá™ que reunir√° a los 5 continentes en el grito libertario de #Carabobo a 199 a√±os del poema: Mi Delirio Sobre el Chimborazo, del Libertador Sim√≥n Bol√≠var 

#23Oct https://t.co/9hpO6ITcQm",28291,26907,27405,82603
268,Desde la @LaVozDeSucre_ üéôÔ∏è Informo El Alcalde del Municipio Cruz Salmeron Acosta @jjAcosta2021: M√°s de 5 mil familias ser√°n atendidas con la Fiesta del Gas en Araya https://t.co/1lciUSV4El,81233,8452,44132,133817
269,"Sres. @CorpoelecCarabo @CorpoelecInfo La ciudadan√≠a entera d Carabobo,espec√≠ficament la d San Diego NECESITA SOLUCIONEN el abuso con los cortes d luz TODOS LOS D√çAS  se va por 4 y 12 horas!Hasta cu√°ndo! No hay excusas,A√±os y NO SOLUCIONAN @NicolasMaduro @rafaellacava10 @mppeevzla",72338,89590,11895,173823
270,@Banesco Gracias !!!,43054,93844,71857,208755
271,Pero como puede ser falso si desde temprano los puntos no.funcionan....aclaren que pasa y se evitan especulaciones .,59888,12068,89320,161276
272,@CorpoelecCarabo @CorpoelecInfo @Corpoelec_Arag @mppeevzla Sin servicio de luz en ciudad alianza guacara Estado carabobo hecho en socialismo mas de 2 hora y nada,70258,83166,27854,181278
273,"El problema del pa√≠s no es s√≥lo si gobierno, es su gente tambi√©n. Y si a juzgar por algunos trabajadores de #Banesco vamos, pues se entiende perfectamente que Venezuela est√© como est√©.",79724,79977,3316,163017
274,"Laidy G√≥mez tal como se expresa convence. Seg√∫n los testimonios de tachirenses que conozco, es una mujer trabajadora, amplia de pensamiento y ecuanime.
De ser as√≠, espero repita en la gobernaci√≥n del T√°chira y de ah√≠ para la presidencia.
#LaidyGomezALa1",98076,71116,77580,246772
275,"¬°La Patria para nosotros es todo!, es por eso que la #FANB no descansar√° en su deber de defender la Patria y sus instituciones. #19Abr #AbrilDeFuegoPatrio #YoSoyFanb #GNBFalc√≥n https://t.co/jyU6nc7g2n",12399,52470,52711,117580
276,"Sepa por cu√°nto tiempo se podr√° mantener el precio del d√≥lar alrededor de 4 bol√≠vares -  #10Oct/, https://t.co/bDjHppvj70",39668,71841,22840,134349
277,@laidygomezf Tu bernalacran. Hay q tener moral..este se√±or reconoci√≥ maduro y obedeci√≥ a una irrita sentencia del ilegitimo TSJ. As√≠ q no hable porque se le chispea la cara,20930,95526,95521,211977
278,"@Banesco Realic√© 2 pago movil y dieron ambos dieron error y los debitaron, el dinero no cay√≥ en el banco receptor https://t.co/eQKICxtyzz",92416,13414,35821,141651
279,@CaraotaDigital Enviar√°n a los de Punto Fijo?? Son todos de la 3a edad en v√≠as de desnutrici√≥n y no pueden con el peso de un fusil,82389,68400,4118,154907
280,"Eso abierto es dilema que un d√≠a Venezuela no reciba cambios de moneda f√≠sica y decida digitalizar su moneda. Desde T√°chira y esos pueblos ser√°n arrastrados como sat√©lite de comunicaci√≥n en la gravedad. ""Bol√≠var digital"" es una realidad. https://t.co/yK473ZGnWe",76570,19114,22467,118151
281,@BCV_ORG_VE ¬øSoltaron al d√≥lar?,63888,79551,3072,146511
282,"El diputado al Consejo Legislativo de #Carabobo,¬†Arvilio Hidalgo, se√±al√≥ que el¬†Ejecutivo nacional debi√≥ establecer medidas econ√≥micas¬†complementarias con la entrada en vigencia de la reconversi√≥n monetaria.

#ReconversionMonetaria

#Reconversion #RumboAlBolivarDigital

(2/6)",69284,85960,3821,159065
283,EN CARABOBO: Operaci√≥n de rescate de un comerciante dej√≥ tres secuestradores abatidos https://t.co/o9pUhScD3L,41560,22315,84218,148093
284,"üõëLa .@GNBunidad_vial se mantiene Activa en el Km-144 de la #ARC estado #Carabobo, Garantizando Seguridad y Auxilio Vial a los usuarios de tan importante arteria vial.

#10Oct #G.N.B #FANB
@GNBCmdtGral
@vladimirpadrino
.@Viloriarca1
#SimulacroElectoral https://t.co/MD85dErhUm",4701,2656,66482,73839
285,@rmfinanzasve @BcodeVenezuela Mi n√∫mero de c√©dula es 14361015. Esto es el colmo que mientras est√©n celebrando con vinos y dem√°s ustedes tienen mi dinero retenido. Como juegan con las necesidades del ciudadano comun.,54965,56517,3940,115422
286,T√°chira: 5ta y 7ma avenida de San Crist√≥bal llenas de basura https://t.co/UP51sZBbH2,61398,10702,50658,122758
287,No tienen verguenza   ahora si necesitan del pueblo cuando se reparten lo que le roban al venezolano ... No piensan en el pueblo si comen o no... Cara dura ...  ,32849,52260,96169,181278
288,Encuentran dos cabezas humanas en una plaza del estado Bol√≠var https://t.co/iAI41TOYUe  #SUCESOS,26848,62445,81291,170584
289,"Ya es hora de abrir y corredor humanitario para los estudiantes de ciudades fronterizas venezolanas.
Hay colegios en C√∫cuta que ya regresaron a presencialidad, y √©stos estudiantes a√∫n no lo pueden hacer.
Ya no m√°s riesgo ni humillaci√≥n al tener que pasar por el r√≠o T√°chira.",43523,5722,23,49268
290,"mas de 120 dias sin inter #19129106, Urb. ricado urriera, Valencia Carabobo,#Aba_cantv_Reportes @ContactoCantv",29280,44955,69856,144091
291,"@nicolasmaduro A√öN SIN RECIBIR RESPUESTA! Trabajadores de CORPOSALUD T√ÄCHIRA activos,incapacitados y jubilados, adscritos a Gobernaci√≥n, espera el PRONTO PAGO de la Retroactividad desde mayo,aprobados en Acta Convenio del 21-06-2021para sufragar gastos de primera necesidad",75614,80827,48941,205382
292,"Hospital de T√°riba en emergencia por la basura
#06Sep #tachira #lasprimicias #Cardenas #t√°riba  #HospitalT√°riba #emergencia #basura https://t.co/xmosMDwoE1",75664,83670,72569,231903
293,"#15Oct #RegionesEnLaMira | @RobertLobo_: En el estado Carabobo, una banda fue detenida por presuntamente dedicarse a la trata de personas, llevaban a los adolescentes a Colombia para que fueran prostituidos en el vecino pa√≠s. https://t.co/6S38Nc3TBU",8198,47502,47026,102726
294,@junior_pedregal Pero luego recuerdo que ya cambiaste amigo.  Me retracto!!,79546,93476,74769,247791
295,"Hoy la Candidata a Diputada Local Por el Distrito XXXII  Sof√≠a Garc√≠a Silva visit√≥ a los vecinos de Pedregal de la Zorra. En Coyoac√°n #LaRutaProgresistaVa 
#RSPCoyoac√°n 
#RSPCDMX 
#JuntosAdelante 
#SanarAMexico https://t.co/AyDylIbwNn",53233,38890,14435,106558
296,Despu√©s de un a√±o de pandemia llegamos al punto donde quedarme con el cambio de las tortillas es mi √∫nico ingreso fijo.,43504,99354,25680,168538
297,"Estamos en reuni√≥n con la Asociaci√≥n Nacional de Supermercados y Abastos (Red Ansa), para conversar acerca del encadenamiento productivo, mantener los precios acordados y que se cumplan  @BCV_ORG_VE. 
#Mon√≥merosEsDeVenezuela 
@NicolasMaduro @EneidaLayaPsuv @ejalvarezg @3mZonia https://t.co/E4g33CRjav",3315,89243,93854,186412
298,"@usembassyve Pen√≠nsula de Paraguana,  Estado Falcon, uno de los lugares m√°s hermosos de Venezuela y sus playas maravillosas, en las noches con cielo que se pueden tocar las estrellas...",71104,70185,81196,222485
299,"Entre el ""Banco Central del T√°chira"" y que aun estando inhabilitado @elgochoceballos haya decidido decir p√∫blicamente que quer√≠a ser gobernador del estado deja todo escrito de la pol√≠tica de este pa√≠s. 

¬°Vergonzoso!",79093,78223,36309,193625
300,"Es posible que algunos no noten diferencia alguna entre un @jguaido o un @RobertoPatino y una @laidygomezf . Yo si la noto. Hay como un sentido de independencia, de consecuencia, de coherencia, y por que no decirlo, de valentia, en ella, que no veo en ellos.",83322,57242,51161,191725
301,Excelente,76512,91629,45426,213567
302,"CON M√ÅXIMO COMPROMISO PATRIO! üëäüáªüá™
#17Oct üé• El MG Juvenal Fern√°ndez L√≥pez @GNBCmdtGral, realiz√≥ visita en el Comando de Zona @GNB41_CARABOBO acompa√±ado del @Rivera_bastardo.
#GNBAragua
#LaVerdadSiempreTriunfa
#PuebloYCEOFANBVenceremos
#GNBAraguaDCR427
 https://t.co/OjLVlB3PNG",77800,98009,68564,244373
303,El carabobo fc no tiene aficionadas as√≠ =( https://t.co/lfVyCWqhzn,43657,55052,38662,137371
304,"TELENOCHE MOSTR√ì LA DURA REALIDAD DE MERLO: INSEGURIDAD Y ABANDONO MUNICIPAL

Telenoche hizo una recorrida por el municipio mas abandonado de la Provincia de Bs. As. Esta vez recorri√≥ Agust√≠n Ferrari y Mariano Acosta. https://t.co/Mlg6zms1k4",25961,79120,77845,182926
305,tuve un ataque de angustia gigante y ahora estoy mirando un punto fijo en la pared mientras como una hamburguesas con cheddar y papas como si nada hubiese pasado.,19930,87327,24906,132163
306,P√©sima broma: Influencer ingres√≥ a tienda con mascarilla pintada y ahora arriesga ser deportada https://t.co/g1ZRQRbz5l,54996,54319,29166,138481
307,"CON M√ÅXIMO COMPROMISO PATRIO! üëäüáªüá™
#17Oct üé• El MG Juvenal Fern√°ndez L√≥pez @GNBCmdtGral, realiz√≥ visita en el Comando de Zona @GNB41_CARABOBO acompa√±ado del Cmdte de Zona GB @Rivera_bastardo.

#LaVerdadSiempreTriunfa
#PuebloYCEOFANBVenceremos https://t.co/zUWDBuqCxy",96005,67062,96679,259746
308,Conozca el precio del d√≥lar del BCV este 6 de octubre de¬†2021 https://t.co/AAc7FhiAvw,56585,26558,48222,131365
309,"Mensaje de GJ .@vladimirpadrino, en ocasi√≥n de conmemorarse los sucesos ocurridos el 27 de febrero de 1989.
 https://t.co/Mtu4e26zHL https://t.co/CneWL0TcVc #FANB #GNBFalc√≥n
#27FRebeli√≥nVictoriosa
#GNByPuebloVencedores
.@NicolasMaduro 
.@cmdtegralgnb
.@GNBGDjuvenal
.@LopezVargasR",22139,12832,64650,99621
310,"@BcodeVenezuela Hola buenas noches, el presente tweet es para preguntar sobre este problema en la App de BDVdigital, intento ingresar y no me deja https://t.co/YfGs58yfkj",99732,82336,14629,196697
311,#ServicioPublico @CorpoelecInfo @NicolasMaduro En este Instante Habitantes de San F√©lix Reportando 7 apag√≥n Blackout en toda San F√©lix Estado Bol√≠var ya son 4 horas del d√≠a de hoy sin Electricidad y con 3 Centrales Hidroel√©ctricas dentro de CIUDAD GUAYANA. üÜòüö®‚ö†Ô∏èüÜòüö®‚ö†Ô∏è,81985,66092,77761,225838
312,Estoy despierto desde las 7 *se queda mirando un punto fijo*,98552,92463,64748,255763
313,"Cdi panamericano Tachira
#MmedicalCubanaTachira 
#HeroesDeLaSalud 
#ACubaPonleCorazon 
#CubaPorLaVida 
@CDIPanamerican1 https://t.co/dvPTGdGGiR",69576,55241,93584,218401
314,"@natdupeyron 
 ayudame a difundir caso acoso NO penado que decepcionante que ante la situaci√≥n actual acto de acoso por un director de √°rea s√≥lo tenga como consecuencia un acta administrativa Jaime S√°nchez director de sistemas en hospital √Ångeles Pedregal es acosador y pat√°n",68747,34883,90475,194105
315,"Miemtras tanto N√©stor Morales y blu radio mordi√©ndose el codo.

https://t.co/n7uKFZYYRM",62734,85185,39646,187565
316,Estamos agobiados por falta de agua @Hidrocentro2011 nos tiene casi 7 d√≠as #SinAgua en la zona norte de Valencia #Carabobo y el covid-19 en ascenso en la entidad @rafaellacava10 @minaguasoficial @NicolasMaduro,1223,45847,64940,112010
317,Base Motor Renault Twingo 8v Derecha 1999 - 2005    35$ 04141755880 (estamos en tachira con sucursal Colombia) 100% seriedad y responsabilidad  #Caracas #Renault #Clio #Symbol #megane #Taller #Maturin #Tachira #barinas #Chacao #Petare #Logan #Martes,52308,89885,84436,226629
318,"D√ìLARES manejan la econom√≠a VENEZOLANA: 
D√≥lar Today
D√≥lar BCV
D√≥lar de los comerciantes que es el que manda sin autoridad.
El comerciante haciendo lo que le da la gana, sin gobierno leg√≠timo ni gobierno interino, nada nadita de nada! ¬øPor qui√©n voto? https://t.co/rdCsrV9zp8",65917,7381,6454,79752
319,"@SENIAT_Oficial @TarekWiliamSaab @sundde_ve  En Ciudad Bol√≠var tenemos un comercio llamado ""El Econ√≥mico"" rif J-317281616 que sabe burlar el sistema, publican el precio en $ bcv pero las cajas facturan en $ negro ‚ö´ ojo con esto se√±ores. https://t.co/xAHes4Z0mB",71257,98333,57765,227355
320,@Banesco Ya les respond√≠ al privado,4797,53852,56259,114908
321,@NOTIFALCON En el municipio piritu baja 20 veces en el d√≠a y 90 veces en la noche (aprox) todos los d√≠as,84706,74158,20659,179523
322,"#INAMEHInforma Precipitaci√≥n Total Estimada y √Åreas con Potencial desarrollo de tormentas el√©ctricas en Centro Norte Costero; probabilidades (L√≠neas entrecortadas) sobre Carabobo, Aragua, La Guaira, Distrito Capital y Miranda. https://t.co/Ktpub32WCv",62947,64972,87736,215655
323,19-10-2021 Trigale√±a Valencia Carabobo sin agua ni luz. @Hidrocentro2011 @CorpoelecCarabo  ustedes no tienen recuperaci√≥n posible por ponerlo elegante.....,95017,31233,53695,179945
324,"Acaba de publicar una foto en Bosque Tlalpan, el Pedregal. MX-DF https://t.co/jvzgCoqYBH",43026,18721,56840,118587
325,"Descubre preferencias sexuales de su esposo e intenta quitarse la vida #PiedrasNegras üö®üöë 

Una mujer se enter√≥ que su marido sent√≠a atracci√≥n por los hombres y se provoc√≥ lesiones en los brazos.

https://t.co/Vwu3mFvDNZ https://t.co/lvDh5r8oWN",94277,68868,68885,232030
326,"@Deamestoy @josesalloumk @genherr15 En Venezuela para ir a visitar a mi MADRE en Upata Estado Bolivar me fui en un taxi desde Caracas y tuve que pasar por 33 alcabalas antes de llegar , debo confesar que las mujeres policias son muy crueles y mal educadas el trato que le dan a la gente joven es humillante",42767,30852,30798,104417
327,#SUCESOS Al calabozo sexagenario que manose√≥ a una adolescente en Punto Fijo https://t.co/KZTOUzejKM,1283,16228,28547,46058
328,@churuguara Hay gente m√°s peligrosa en Aragua que arrechera pol√≠tica contra gente inocente vamos @_Provea creo que se requiere su ayuda @AsambleaVE @TAMARA_SUJU,29561,60171,99460,189192
329,"CEM Valmore Rodr√≠guez Valencia sigue dando el msj de optimismo y de UNIDAD plena en Carabobo, los ADecos que respaldamos la institucionalidad, los que apostamos por ""Una Venezuela libre y de los Venezolanos"" votaremos este 21n por la tarjeta la MUD, la Manito Azul. UNIDAD plena. https://t.co/QKWaoa6qq8",38706,97637,82930,219273
330,"Secuestraban a menores en Caracas y Carabobo para luego prostituirlos en Colombia
https://t.co/KuVwcA2lvX",46128,23167,25225,94520
331,"PARAGUAN√Å es la capital econ√≥mica de Falc√≥n, representa la mayor palanca para nuestro desarrollo.

La miop√≠a de muchos de quienes la han conducido los destino, no lo han entendido as√≠.

Paraguana est√° destinada al √©xito, estoy convencido que as√≠ ser√°.

¬°Dios bendiga a  Falc√≥n! https://t.co/bmbBXlGwyb",95663,88989,67757,252409
332,"Qu√© fruct√≠fero encuentro sostuve con Fedec√°maras y las 13 C√°maras de Comercio del #T√°chira, donde sumamos propuestas para la recuperaci√≥n econ√≥mica en el marco de los acuerdos para la apertura gradual y progresiva de la frontera entre nuestra entidad y Norte de Santander. https://t.co/SnWOOZF20q",67940,80572,49580,198092
333,"#NOTICIAS | üìπ Un #abuelito le cant√≥ las ma√±anitas a su nieto desde #EaglePass, Texas, mientras su nieto Santiago lo escucha del otro lado del r√≠o Bravo, en #PiedrasNegras, Coahuila.

‚û°Ô∏è https://t.co/fnC2604IhB https://t.co/ejiw3JOgvY",32921,40758,30902,104581
334,"#Tachira detienen 3 cddnos  y retenci√≥n de 01 veh√≠culo tipo gandola con compartimento secreto, para el posible tr√°fico de sustancias il√≠citas.
#21Ago #GNB #CEOFANB
#UnidadLuchaYVictoria
#GNByPuebloVenciendo
#FANByPuebloDePaz
.@NicolasMaduro
.@GNBCmdtGral
 https://t.co/8YHMyJSVn6",4645,71287,83682,159614
335,"@CFE_Contigo Fuentes del Pedregal,  Alcald√≠a de Tlalpan sin luz desde hace dos horas. Que pasa?",69055,13902,57207,140164
336,@NoticiasFalcon @TarekWiliamSaab Est√° loco,2824,9006,93322,105152
337,"El #IVSS presente en la comunidad de El Rinc√≥n, en el municipio Libertador del estado Carabobo; en el marco del Plan de Amor en Acci√≥n a las V√≠ctimas de la Guerra Econ√≥mica que nos ha orientado nuestro pdte. @NicolasMaduro #JuntosSomosM√°s #PorUnSeguroM√°sSocial @MagaGutierrezV https://t.co/YRzCED2SLh",31552,34376,6991,72919
338,"TODOS CONTRA UNO COMO BRUNO, TODOS CONTRA EL PEOR: TU DESTRUCTOR, NI PINTURITAS QUE SE CAEN DE AGUA.  NI TONINAS MENTIROSAS DE LINGUISTICA Y CONTENIDO LIMITADO REPETITIVO AL MEJOR ESTILO DE LA Q  NADIE SABE Q HIZO EL DINERO PARA ""BA√ëARNOS"" EN EL GUAIRE, LA MISMA Q GRITABA Y PATALEABA DESMONTANDO EL 30 DE DICIEMBRE DE 2012, LA TARIMA Y LOS ACTOS DE LA PLAZA BOLIVAR... QU√â SILENCIO, Q ENCUBRIMIENTO, QU√â COMPLICIDAD TAN SAT√ÅNICA.....SON IGUALES, ENGORDAN Y SE REVIENTAN CON EL PAN Y EL SUE√ëO DE LOS VENEZOLANOS....VOTA INTELIGENTE, SI ESTAS MUY BRAVO, VOTA CONTRA EL PEOR,,,, TOMEMOS PAMPERITO CON EL LAPIZ EN MANO",47550,34048,12992,94590
339,Daniel_RiosVE: Hispana habr√≠a sido asesinada a pu√±aladas por su propio novio en San Bernardino https://t.co/NeMj2z6Nee #DanielRiosTeInforma #GacetaCarabobo #Carabobo #Venezuela,31262,55293,69437,155992
340,"@SudebanInforma @NicolasMaduro CON LA NUEVA REEXPRESI√ìN MONETARIA VOLVIMOS A RETROCEDER YA CAJEROS AUTOM√ÅTICOS COMO BANESCO,BNC,NO EST√ÅN DISPENSANDO EFECTIVO A :BCO.VZLA,BCO.BICENTENARIO,BANCAMIGA,ETC",19,94851,77515,172385
341,"En sesi√≥n para la exposici√≥n ‚ÄúLegado Jardines del Pedregal‚Äù junto a Luis Gordoa y Arturo Rivera 

(Click en las fotograf√≠as) üëáüèª

#shotoniphone https://t.co/gs1bMAtgns",25213,55400,11664,92277
342,"Centinelas del .@GNB41_CARABOBO, realizar√≥n la aprehensi√≥n de un (01) Cddno solicitado por el delito de Violencia de G√©nero, A/O del @MinpublicoVE #GNBCaraboboSeguro #4Oct CEOFANBPorlaPatria #Vacunaci√≥nAbierta
#CentinelasDelPueblo
.@libertad003
.@GNBCmdtGral https://t.co/QkPJCfidlE",68371,6932,21544,96847
343,"ü™¥Aprenda a cultivar alimentos en entornos urbanos.ü™¥ Participe en nuestros talleres presenciales, ¬°SIN COSTO!üì¢Inscr√≠base aqu√≠ ‚û° https://t.co/p0EAeZDZ5i ‚¨Ö Invitan: Consulado de #Colombia en #NuevaYork y Colombia Nos Une de @CancilleriaCol.üá®üá¥üá∫üá∏ https://t.co/oflhcPC2r5",77546,12042,37407,126995
344,@vampipe Espero pasen pronro a bombardear por aca en pedregal https://t.co/xvULp1yH5D,84646,20973,22426,128045
345,@NellyverLugo @FreddyBernal @Juntosxtachira1 @Redi_andes @ZODI_TACHIRA @TareckPSUV Les sale bonito jugar con la necesidad de la gente,94701,34760,90472,219933
346,"Acaba de publicar una foto en Coro, Falcon https://t.co/kwu0KsLjL5",87528,63306,20984,171818
347,Daniel_RiosVE: EEUU: cada vez m√°s ni√±os y adolescentes mueren baleados https://t.co/YdKWfBKWkS #DanielRiosTeInforma #Carabobo,57397,10047,10606,78050
348,"üáªüá™ | AHORA

Dos j√≥venes salen ilesos luego del impacto de un rayo.

Un adolescente de 15 a√±os y otro de 17 resultaron con lesiones leves luego de recibir el impacto de un rayo, mientras se resguardaban de la lluvia en un campo de beisbol en el estado Carabobo.
‚Å¶@ReporteYa‚Å© https://t.co/lgsYugn8r0",91588,64197,87489,243274
349,"El .@FalconGnbcz mantiene despliegue en el territorio Falconiano, para garantizar la seguridad y la salud del pueblo. #3Abr 
#SputnikVGarantizaVida
#GNBGaranteDePaz 
#FANBEnDefensaDeLaDignidad
.@NicolasMaduro 
.@cmdtegralgnb
.@LopezvargasR
.@GNBGDjuvenal https://t.co/WwTg0Cy2fS",54700,51436,13063,119199
350,"¬°Conoce m√°s sobre tu #USM!‚Å£
‚Å£
Nuestra sede en Barinas, fue inaugurada el 15 de noviembre del 2004, para dar respuesta a la demanda existente en formaci√≥n universitaria y del desarrollo productivo del Estado.‚Å£‚Å£
‚Å£‚Å£
Hoy en d√≠a cuenta con 3 facultades y ofrece 6 carreras. https://t.co/TZMioo73KU",29965,8736,90559,129260
351,Lacava: Este viernes se comenzar√° a bombear agua al norte de Valencia https://t.co/LCLALOSSQl #noticias #carabobo #venezuela https://t.co/fNHpwNcBxj,12067,5703,92457,110227
352,"BCV: Inflaci√≥n de septiembre se ubic√≥ en 7,1%, la m√°s baja del a√±o | #Econom√≠a |

https://t.co/9w24Wi7xlj",89964,21621,8120,119705
353,"""Su premisa fundamental fue que Diario La Naci√≥n estuviera al servicio del T√°chira: no hab√≠a iniciativa de progreso y desarrollo que no contara con el decidido apoyo del diario""
 https://t.co/9dfNpSEijc",69364,47438,37555,154357
354,"Carabobo tiene ataque, solo falta definici√≥n.",12644,44561,94589,151794
355,"Pues lo est√°..preg√∫ntale y ver√°s. Se fue con @adbernabe. En T√°chira ella representa al gobierno de @nicolasmaduro. 
El que cobra por Miraflores es empleado de Miraflores. https://t.co/dtgZmYKHNT",56879,96699,35987,189565
356,"Nos complace presentarles la inclusi√≥n de la cr√≠a de Codornices del Proyecto Av√≠cola, el cual hace parte de la Agropecuaria CARABOBO. En nuestra casa estamos convencidos que PRODUCIR ES VENCER, por ello trabajamos diariamente por alcanzar el 100% de operatidad de la Agropecuaria https://t.co/cFF2Gjgzrb",11452,68900,78819,159171
357,"@NicolasMaduro                      Corporaci√≥n de Salud Tachira, agradece el Pronto Pago de Homologaci√≥n adeudada a todos los trabajadores. Mayo, junio, julio, ya aprobada x acta convenio el 17-mayo 2021 y viendo la Inflaci√≥n extrema que existe aqu√≠ en Venezuela.",78773,54894,441,134108
358,"#SinLuz desde la 1:15 PM en Bello Monte, Parroquia Rafael Urdaneta del Municipio Valencia del Estado Carabobo",1749,37481,2645,41875
359,"ü•áTe invitamos a consultar el veredicto de la cuarta edici√≥n del Premio Lo Mejor de Nos, luego de evaluarse los 55 textos participantes üëâ https://t.co/eWHFfC7PVS üëè

#BanescoContigo #LVN #LoMejorDeNos",13008,37817,22052,72877
360,"Considerados como aquellos espacios para hacer pr√°cticas por parte de los estudiantes, los laboratorios de las universidades p√∫blicas en T√°chira, se encuentran aniquilados debido a la falta de inversi√≥n por parte del gobierno nacional.
#25Ago 
https://t.co/GFFlhN399q",28668,465,16736,45869
361,"Alumbrado p√∫blico en mal estado en Sim√≥n Bol√≠var entre holanda y Eliezer parada. Peligroso, en plena ciclov√≠a corren riesgo los ciclistas, una persona o incluso una mascota. @MuniNunoa @EmiliaRiosS https://t.co/jfplteB1nh",89555,64033,35824,189412
362,"@hhernandezluis @yosoyangelcr En Tachira, en la zona del Corozo, a 15‚Äô de San Crist√≥bal, hay aguas termales. Desconozco si hay relaci√≥n con alg√∫n volc√°n inactivo. Aunque obviamente, este hecho no ha sido inspiraci√≥n para la letra de la canci√≥n.",3099,50738,49645,103482
363,"@RenteriaFiscal De hecho deber√≠a haber un solo impuesto para todos, un impuesto fijo sin relaci√≥n a lo que ganes o no y un impuesto fijo generalizado al consumo y listo, paga m√°s quien m√°s consume punto. Paga menos quien m√°s trabaje. Y el Gobierno para lo que fue hecho, para dar seguridad.",91959,84920,5568,182447
364,@picsandvideos1 @migueladuque58 @monitordolarvla Si chamo la ley sea por igual que bloqueen a BCV tambi√©n manipuladores,55695,13769,51988,121452
365,Plan Cero Botes de Agua beneficia a 38.700 familias en Falc√≥n https://t.co/Kx9r12RqQb https://t.co/PfmDsuCjvS,83645,92045,66636,242326
366,"#VielmaMora 

Dato: en las mesas cambiar√≠as ellos son la banca privada los que fijan el precio del üí≤ BCV que les parece pagan y se dan el vuelto. ‚§µÔ∏è https://t.co/5tZcWs3rjH",31531,79463,32887,143881
367,"@NellyverLugo @FreddyBernal @Juntosxtachira1 @Redi_andes @ZODI_TACHIRA @TareckPSUV La placa n√∫mero 4 para motos tenemos unos 20 d√≠as sin surtir en SC, necesitamos combustible, avoquense a hacer el trabajo bien porfavor",91958,76222,5204,173384
368,"¬°Confirmado! Ma√±ana por la 94.5 FM tendremos 2 invitados de lujo, el Ing Jes√∫s Mart√≠nez Jefe de @UEMPPATachira y el Ing @JuansuarezR_ de @CiaraTachira con quienes conversaremos sobre la la Producci√≥n y la articulaci√≥n con los #Clap en #Tachira 
#ClapTachiraSoberaniaAlimentaria https://t.co/598DX6IHki",22593,41614,88822,153029
369,"CDI 19 de abril estado Bol√≠var ,M√°s que m√©dicos, ser√°n celosos guardianes de lo m√°s preciado del ser humano; ap√≥stoles y creadores de un mundo m√°s humano. #CheM√©dicoInternacionalista #H√©roesDeLaSalud #CubaPorLaVida #CubaCoopera @cubacooperaven @MINSAPCuba @japortalmiranda https://t.co/pHwstXvukH",97295,17057,13107,127459
370,"de all√≠ afecta a toda la actividad comercial de la zona. Lo peor es que la cotizaci√≥n del ‚Äúd√≥lar del BCV de Las Pulgas‚Äù sirve de referencia tambi√©n para el comercio informal, abastos, mercaditos p√∫blicos, tiendas de barrio y todos los que se abastecen en el casco central y operan",43502,31559,18361,93422
371,@laidygomezf Ese hombre va a la oficina cantv solo por calentar la silla pero no soluciona nada para arreglar esas lineas de cantv entonces las personas de la calle 3 en el cerro diagonal al antiguo banfoandes en la salida via al llano estan incomunicados ace a√±os,52815,1871,85230,139916
372,"Un total de 01 tonelada de Material Ferroso fueron recuperados, gracias a las labores de patrullaje de los  efectivos castrenses de la .@GNB41_CARABOBO #GNBCaraboboSeguro #13Oct  PuebloPatriota
#Mon√≥merosEsDeVenezuela
UnidosPuebloyGNBEsSoberan√≠a
.@libertad003
.@GnbGaranteDePaz https://t.co/qQbXugbpUq",57641,14181,42753,114575
373,"El .@FalconGnbcz mantienen constante monitoreo del cumplimiento de las medidas de bioseguridad en el territorio Falconiano. 
#12Abr #FANB #GNB
#GNByPuebloALaVanguardia
#PuebloComunicadorRebelde
.@NicolasMaduro 
.@cmdtegralgnb
.@GNBGDjuvenal
.@LopezvargasR https://t.co/4roo87APsV",46679,57579,8074,112332
374,Veo a un punto fijo y ya empiezo a entrecerrar mis ojitos https://t.co/FRGNBEepEE,28105,22005,27501,77611
375,Debe especificar para q la gente entienda. Secuaces son guaido Leopoldo falc√≥n rosales bertucci osea la falsa oposicion en todas sus mutaciones https://t.co/ML5gNNV3Qz,50517,31800,21,82338
376,"Familiares de una de las v√≠ctimas hab√≠an denunciado que se estaban llevando a adolescentes con destino a Colombia con el fin de prostituirlos https://t.co/dq6tQag7uC

Por üñäÔ∏è@RCamachoVzla",86253,52869,61752,200874
377,Suerte nisiquiera da el saldo ,19881,45037,85630,150548
378,Ceballos le debe al #T√°chira muchas explicaciones que seguro no no va a dar... Otra duda... Y ahora c√≥mo queda Williams M√©ndez? #12Sep https://t.co/CegZseI6CK,82057,22669,47210,151936
379,"#Atenci√≥n || Estas son las piezas de la nueva Expresi√≥n Monetaria que coexistir√°n con los billetes del cono monetario actual, los cuales estar√°n en circulaci√≥n hasta que el @BCV_ORG_VE determine.

¬°Venezuela avanza hacia la Econom√≠a Digital! https://t.co/38qtDtFgRn",65731,94672,88732,249135
380,"Agua natural, esencial para correcto funcionamiento del cuerpo, destaca Seguro Social
https://t.co/4rVK4t6uod
#PiedrasNegras #Salud https://t.co/x9m5mjBnI7",54908,84444,49378,188730
381,"@BcodeVenezuela Todo este tiempo en una llamada para tratar de poner el reclamo del dinero que me debitaron y ni siquiera contento un operador... Que falta de respeto y √©tica de una instituci√≥n que pertenece al ""PUEBLO"" https://t.co/l4HsIjQpZ3",92003,42759,92385,227147
382,Fuerte baj√≥n de electricidad en San Diego Edo Carabobo... Se va a acabar el mundo,94016,71407,42274,207697
383,@dougie_j_falcon @alice_gas This is *absurdly* a point of controversy in the evolutionary biology community üòÇ,5710,25787,42403,73900
384,"#19Oct En 1938 Nace Eugenio Montejo fue un poeta y ensayista venezolano, fundador de la revista Azar Rey y cofundador de la Revista Poes√≠a de la Universidad de Carabobo. https://t.co/8J717k6TQG",37335,10072,94350,141757
385,Nuevamente falla el servicio el√©ctrico en el municipio Sim√≥n Bol√≠var del estado Miranda.,23001,66467,56690,146158
386,"@alcibiades16 @NeftaliZamoraI @CholoMatrero Hola Alcibiades, es correcto el objetivo de nuestro servicio T536 Corredor Norte-Metro Pedregal-Metro San Isidro es brindar conectividad entre la zona Este y la zona Norte aumentando opciones de viaje y disminuyendo los tiempos de espera de nuestros usuarios.",90277,94259,64696,249232
387,"#Carabobo #Sinluz #7Octubre 
NUEVAMENTE A OSCURAS 
Gracias HDP
Saben qui√©n va a Votar el CDLMQLP..",77436,54962,33562,165960
388,"@PartidoPSUV #Indexaci√≥nSalarialYa Co√±o pero que opinan de la propuesta entreguista de @FreddyBernal disque autorizar abrir cuentas en pesos en los Edos Tachira, Barinas, Apure el Zulia osea entregar terrenos para que nos invadan o mejor dicho terminar de entregar nuestra soberan√≠a",1675,97901,78963,178539
389,@Diaz_4 @RaulZambrano7 @RomeroNestor Y por otro lado yo jurar√≠a por cosas que he le√≠do por aqu√≠ que en T√°chira tienen 100 a√±os de cultura futbol√≠stica...,44308,36607,70305,151220
390,"#amorubioinviertoenrubio #pisadassobrehuellas #radioangel #amorpropio #Venezuela #rubio_city #rubiotachira #junin #fotografia #rubiojunin #folcklore #ciudadpontalida #quibor en Rubio, T√°chira, Venezuela https://t.co/XDJL2ZoAvB",16499,55492,15702,87693
391,@Jojotoweb @AxiomaReport @BcodeVenezuela As√≠ mismo es los dos √∫ltimos bonos no me han llegado..presidente revise esa situaci√≥n..demasiado malestar por ese hecho en la calle ..es cuesti√≥n de i formatica algo anda mal .a pocos d√≠as de las elecciones,19362,83516,84766,187644
392,La gata se despierta de la siesta y se queda mirando un punto fijo un rato hasta que se acuerda que se levant√≥ a comer. Lo que se dice mi verdadero animal espiritual,89521,41267,47102,177890
393,"Ese banco o los t√©cnicos inform√°ticos son unos malandros a mi m√°s nunca me repusieron mi plata pero como a nadie se le reclama q se lo cojan total ellos creen q es un beneficio para ellos la biblia dice un vers√≠culo que dice que con la vara que medis, ser√°s medido",59872,53610,4032,117514
394,"@HIDROFALCON 

Cuando el agua por tuberia para la Pedro Manuel I yII",71824,94227,57096,223147
395,"En 120 d√≠as los residentes de San Crist√≥bal contar√°n con un renovado complejo deportivo.
Informaci√≥n por: Yolanda Torres Salazar.

#NoticiasSertv
#Prot√©getePanam√° https://t.co/ZfJ4mUOwD8",21452,47048,48998,117498
396,carabobo https://t.co/eBgV7g3RU8,46696,747,42212,89655
397,#MonitorDeV√≠ctimas |¬†El asesinato de Valentina es uno de los tres homicidios registrados en el estado T√°chira entre el 9 y el 11 de agosto https://t.co/aZ4i5PDF3a,62812,60689,86187,209688
398,@BcodeVenezuela hola buenos dias alguien sabe porque me aparece saldo negativo en el banco? si no se deve nada,39551,67567,81446,188564
399,"En el a√±o 2018 salio un candidato a la calle a decirle al pueblo que hab√≠a que dolarizar al pa√≠s , nadie salio a votar,(HF) el pueblo en el 2020 asume la propuesta anterior y pone en marcha la dolarizaci√≥n,nace un monstruo DolarToday VS BCV atacan al pueblo y galopa la inflacion.",47407,37469,39834,124710
400,#Carabobo El prop√≥sito es rehabilitar la vialidad y alumbrado p√∫blico en Valencia https://t.co/Tlbcp81k24,13363,35900,13390,62653
401,Pizarro dice que crisis migratoria venezolana se acerca a la mayor del mundo https://t.co/u0NGHyAC2c #noticias #carabobo #venezuela https://t.co/NmgEpOEde6,91620,66953,20866,179439
402,"Hoy te invitamos #18 agosto al programa #LaHoraDeLosClap 8 am por Yvke mundial Tachira 94.5 FM. Estar√°n Juan Su√°rez director de Ciara Tachira y el Dr. Hern√°n Colmenares m√©dico. veterinario, y fundador de @AsoGirolandoVen
#SoyComunicadorClap https://t.co/OOZlcEA48U",29940,3465,41058,74463
403,@Banesco a la espera de la respuesta,93240,75253,85372,253865
404,"#UnDiaComoHoy de 1968, el Gobernador de #Coahuila, Braulio Fern√°ndez Aguirre, y su hom√≥logo de Texas, John B. Connally, inauguran el puente internacional ‚Äú#PiedrasNegras - Eagle Pass‚Äù. https://t.co/mR9LRglQiN",49997,31700,45171,126868
405,"#EspecialVPItv |  La comunidad de Las Mar√≠as en Naguanagua, estado Carabobo, enfrenta un grave brote de leishmaniasis y los bajos recursos que perciben la mayor√≠a de sus habitantes dificultan su situaci√≥n.

üëâ https://t.co/cSkeD8e9mn https://t.co/B4L1bKf8Dz",62463,59215,96863,218541
406,T√°chira: Detenidos tres polic√≠as de Carabobo con euros presuntamente provenientes del narcotr√°fico,17510,55919,86337,159766
407,"üáªüá™ Docentes organizados se pronuncian en torno al rechazo de la cancelaci√≥n de salarios a trav√©s del Sistema Patria, ante la Defensor√≠a del Pueblo introducen un documento petitorio para q sean transferidos los derechos nuevamente a sus patronos directos... https://t.co/0OCDzVb4RD",78492,56926,80871,216289
408,"@carlostaba @Banesco Gracias, si, luego me percate, sin el wiffi pude entrar desde mi tlf.",70725,75673,89053,235451
409,"@CONAFOR Reporto un incendio en reserva del Pedregal, a la altura de colonia Pedregal de San Nicol√°s, Tlalpan Cdmx. Hay una gran columna de humo en el cerro",6720,60724,32594,100038
410,"CDI la Unidad Estado Bol√≠var
#SomosDelBarrio
#CDRCuba 
@Cubacooperabol2 
@AnayansyPR 
@CubaVa_Bolivar2 https://t.co/ROrZXBJCZ4",51116,41668,3588,96372
411,"@Carolin41965810 @sundde_ve @EneidaLayaPsuv He visto que muchisimos comercios compran dolar a la tasa BCV gracias a las cuentas custodias y aun as√≠ especulan con el paralelo, lo digo con bases...",7550,11461,14071,33082
412,"Se est√°n realizando varios operativos para dar con la ubicaci√≥n de bandas que se dedican a la trata de personas en Carabobo y otros estados del pa√≠s https://t.co/dq6tQag7uC

Por üñäÔ∏è@RCamachoVzla",15275,83683,8718,107676
413,@usembassyve Pen√≠nsula de Paraguana üëèüëèüëè,21495,89286,13994,124775
414,@BcodeVenezuela Buenas noches me meto en la p√°gina de bdvdigital opt√≥ la opci√≥n de movimientos recientes y no me salen reflejado como en d√≠as anteriores sal√≠an reflejado hasta los dep√≥sitos que me hac√≠an le agradezco la mayor colaboraci√≥n antes la situaci√≥n antes mensionada,13325,94977,50307,158609
415,"Venezolanos en 7 pa√≠ses podr√°n pedir pr√≥rroga de pasaporte a domicilio‚Å£‚Å£.
‚Å£
""Ser√°n beneficiados los compatriotas que vivan en los pa√≠ses: Colombia, Costa Rica, Honduras, Guatemala, El Salvador, Estados Unidos y Brasil""‚Å£‚Å£. Inform√≥ Gustavo Vizca√≠no¬†
https://t.co/u4O7h0Dnvg https://t.co/SKTdn6GBan",26656,15693,40163,82512
416,"@emramrojasm @LucyPN Claro, esa tasa del BCV favorece solo si se paga en Bs..... si se paga en divisas NO vale la pena. Mejor venda sus $$ a una mejor tasa y paga en bs",24395,56941,7064,88400
417,"@izquierda2536 El precio del d√≥lar no lo establece el BCV. El BCV solo publica el ponderado de la mesa de cambio de los bancos p√∫blicos y privados.
Los usuarios de la banca son quienes de acuerdo a la oferta y demanda establecen el precio que pondera la mesa de cambio.",63145,73229,56003,192377
418,"Planes de Internet de hasta 50 megabytes ganan popularidad en T√°chira | @GabyMagilbray 

 https://t.co/LoFVx61iu6",24507,52868,93621,170996
419,"@HctorCa83916465 A excepci√≥n del estado T√°chira que comercia con pesos y Bolivar y Amazonas con el oro la moneda de curso legal, transaccional es ese que tanto le incomoda al r√©gimen pero como le gusta!!",63296,99325,38111,200732
420,"#Efem√©rides üìÜ || El #15Oct de 1726 nace en La Victoria, estado de Aragua, el padre del Libertador Sim√≥n Bol√≠var, Juan Vicente Bol√≠var y Ponte Andrade. Fue un activo propulsor de la independencia de Venezuela desde 1782, quien defendi√≥ fervientemente los ideales de libertad. https://t.co/Lir3qe8fMN",37525,10128,11176,58829
421,"@ErikaOSanoja @VTVcanal8 üò± la dejadez que hay ya es ins√≥lito. La autoridad del Estado tiene que hacerse sentir y sancionar a quienes realicen estas pr√°cticas. A lo que ha llegado esto de la ‚Äúdolarizaci√≥n informal‚Äù, todos est√°n obligados a recibir el bolivar, es nuestra moneda de curso legal, no el d√≥lar",35660,64325,41487,141472
422,"Serie disponible Latino
#naguanagua #valencia #carabobo #venezuelaüáªüá™ #serieslatino #hd #temporadas en Barrio Union https://t.co/fFUKwUNSXG",56729,85832,65406,207967
423,"Maria Bernarda Amar√® Itriago, estudiante de Derecho en la Universidad de Carabobo https://t.co/WQhv3piCe7",41020,3826,80365,125211
424,"¬øCu√°ndo van a incrementar los l√≠mites de las tarjetas de cr√©dito?, pero en serio vale, no esa mamadera de gallo que hicieron hace unos meses.",77678,98733,35336,211747
425,((EN VIVO)) #RED12 con H√©ctor Sergio Barboza/Ernesto Ram√≠rez en los Deportes‚öΩÔ∏è/ Cynthia Via√±a ‚ÄúLa Autoridad En El Tiempo‚Äù üå¶/Centro de mensajes: üì≤ 878 1 22 22 22/ Esc√∫chenos tambi√©n en la 96.7 FM üéô#PiedrasNegras https://t.co/7ouCrXFq2b,69627,78643,43526,191796
426,"Hoy caminamos junto a nuestros compa√±eros de la @AlianzaDemocVE y a la Gobernadora @laidygomezf las calles de San Cristobal Estado T√°chira. Hemos sido coherentes y el tiempo nos ha dado la raz√≥n, el voto es un instrumento de lucha.  Juntos somos m√°s. @ElCambioVE https://t.co/jNmjfnjJCk",33286,71449,84868,189603
427,@jglunar Por una bombona de ox√≠geno en Punto Fijo cobran 100$... que abuso sabiendo como estamos por culpa de este dichoso virus... y en China no hay Covid??,19415,49694,76228,145337
428,#SUCESOS Encuentran dos cabezas humanas en una plaza del estado Bol√≠var https://t.co/iAI41Txo2G,53417,17516,6945,77878
429,"Pura pol√≠tica y propaganda por las elecciones luego se olvidan de todos y de todo.20 a√±os diciendo mentiras y todav√≠a hay gente ignorante creyendo todo,esa gente de jam√°s cambiaran su manera de actuar.  Esos son los q m√°s roban extorsionan y da√±an .",64959,44382,62578,171919
430,"@FelicianoValen Bandidos como Feliciano, celebran que bandidos como Bolivar, hagan lo que les de la gana apoyando v√°ndalos, y m√°s bandidos y traquetos los miembros del Consejo de Estado. Farsante este aborigen",25514,61679,82253,169446
431,"Familiares le solicitan a la direcci√≥n regional de Cultura del estado Falc√≥n apoyo con algunos m√©dicamentos. 

A pesar de la atenci√≥n recibida en el centinela de Coro, durante semanas su familia y vecinos lideraron una campa√±a para adquirir algunas medicinas. #30Mar",20700,3675,97444,121819
432,@drhenrygarciap @ucom_vzla Y lo que sucedi√≥ en la operaci√≥n el d√≠a 27 de agosto con la paciente que falleci√≥  tambi√©n est√° feliz ? Con muy poca √©tica Usted sea responsable #JUSTICIAPARAKARLA @TarekWiliamSaab #justicia #tachira #venezuela #JUSTICIAPARAKARLA #SanCristobal,55547,7771,56582,119900
433," Felicitaciones, Porfa Chacaito y Sab, Grande necesitan un cari√±ito, muchos buhoneros y ensucia demasiado. POR FAVOR!!!  Gracias.",66098,23004,31621,120723
434,"#EspecialVPItv | Tramitar la c√©dula, una odisea que no distingue edad

En el estado Carabobo, Venezuela, las oficinas del Servicio Administrativo de Identificaci√≥n, Migraci√≥n y Extranjer√≠a (Saime) no se dan abasto para atender a la poblaci√≥n.

üëâ https://t.co/LRlTDTsYLd https://t.co/VrTxIQVl8w",20600,975,81146,102721
435,"#22Oct//@centineladelaf1// Cumpliendo Instrucciones GJ @dhernandezlarez MG @Redi_andes GD @ZODITACHIRA21, GB Cmdte @25brinfmec efectu√≥ Reuni√≥n de Coordinaci√≥n  con sus Cmdtes de Unidades y E.M. de esta U.S., con motivo de la Ejecuci√≥n del Ejercicio ""Bicentenario de Carabobo 2021"" https://t.co/DstN5kDANC",27482,22472,90203,140157
436,Entendemos! Pero no resuelven porque llevo dos dias sin poder comprar comida como se le dice a un hijo (entiendo que tengas hambre pero estoy trabajando en eso),99367,92849,55731,247947
437,"Acaba de publicar una foto en Coro, Falcon https://t.co/r4m1E4tpRf",477,42803,87501,130781
438,Pendiente polichoros de la PNB jodiendo cerca del liceo Sim√≥n Bol√≠var. @elPULP0 @omairalabradorm @lorearraiz @williamsAmaya @Noticia_tachira @MarquesSeboruco @pizarro354 https://t.co/EMKwF1CJvJ,93835,87228,94179,275242
439,"@segurosybanca ..Por Aqui..Con la que LOGRA muchas ADQUISICIONES a precio de GALLINA flaca,aprovecha el desequilibrio del BANCO UNION y salva a SALVATIERRA de la depresi√≥n y se catapulta lej√≠simo en el sistema financiero,ya BANESCO no le sirve""POR AHORA"" mientras exista este SISTEMA en el poder",97018,4235,87252,188505
440,"@sagaxvenezuela @lucilangelm @AsktoMandrake El d√≠a que esta chavista necesite vender unos dolaritos, quisiera verla ofreci√©ndolos a precios BCV üòÇüòÇüòÇ. Ah√≠ va a ser la primera que diga que su vaina la vende ""a precio de p√°gina"".
A estos vagos hip√≥critas les fascina disponer de lo ajeno.",44814,36723,23803,105340
441,La advertencia de las autoridades a quienes vayan a playas o balnearios en Falc√≥n https://t.co/oinOE4dVIs,95592,33631,44483,173706
442,@minaguasoficial @Hidrocentro2011 @RMarcoTorres @hidrocaribe @VTVcanal8 @EvelynBVasquez @delcyrodriguezv @Jenireezerpa @Mippcivzla #agua #SinAgua #rafaellacava #hidrocentro #tranca #Vecinos #mundo #VALENCIA #Carabobo #Venezuela #autopista #regional #centro #Gobernacion #alcaldia #Noticias #urgente #COVID #VacunaCOVID19 #Salud #higiene #enfermedades #Derecho ü§¨ü§¨ü§¨ü§¨ü§¨ü§¨ü§¨ü§¨ü§¨ https://t.co/uLUSPDeJUj,4404,17708,57331,79443
443,#INTERNACIONALES Descubren una nueva cepa de coronavirus en T√∫nez https://t.co/5407WP2eVb,61612,88036,81088,230736
444,BCV suspende proceso de tramitaci√≥n y otorgamiento de autorizaciones para operar como Proveedor no Bancario de Servicios de Pago https://t.co/YN64nirj4L\',64033,86185,14110,164328
445,"üå™Ô∏èüò±#Viral #PorSiNoLoViste #Hidalgo Un ‚Äútornado‚Äù sorprendi√≥ ayer a los pobladores de #Apan, Hidalgo. Seg√∫n Protecci√≥n Civil de Hidalgo, los hechos se registraron en la colonia Lomas de Pedregal, dejando como saldo, da√±os en √°rboles, bardas y techos de l√°mina de viviendas. https://t.co/VoqBSH6z6z",91453,56783,49768,198004
446,Arreglen la mrdt plataforma y regresen el dinero que me robaron de mi cuenta....,24821,81216,47302,153339
447,Yo tengo d√©bitos en mi cuenta que no corresponden ya que no los realice y con montos exactos a otros realizados antes del desastre. A qui√©n le reclam√≥ si hasta me dejaron la cuenta con saldo negativo?,77352,55395,31200,163947
448,"Tren de Aragua
Denuncia ciudadana üö®üö¶üö•
San F√©lix, estado Bol√≠var: este par se sujetos con pinta de polic√≠as detuvieron el pasado 16 de octubre a un ciudadano que se dirig√≠a de San F√©lix al Callao y llevaba 30 litros de gasolina de su propiedad para el viaje. Como se observa el https://t.co/9rdp84Emrm",38964,53725,92203,184892
449,"#ENT√âRATEüì£| El #28Oct inicia el XV Festival Mundial de Poes√≠a de Venezuela üáªüá™ que reunir√° a los 5 continentes en el grito libertario de #Carabobo a 199 a√±os del poema: Mi Delirio Sobre el Chimborazo, del Libertador Sim√≥n Bol√≠var 

#VacunarseEsVida https://t.co/5MNk7FxTO7",14639,87017,66492,168148
450,"@ClasMeri Base Cooler para Mini Laptop de Aluminio con 2 Fan con Cable USB M/M para la conexi√≥n, 6$. Hacemos env√≠os nacionales #Cooler #Laptop #USB #Vende #TecnoAccesorio #Carabobo #Valencia #SanDiego #mercadolibre https://t.co/0yV832TgIE https://t.co/NqdNlIoM1j",74156,90063,21118,185337
451,"#27Ago #RegionesEnLaMira | Dirigentes sindicales del estado T√°chira, protestaron por movilidad de n√≥minas al sistema Patria. @LuzfrandyC ampl√≠a la noticia 
https://t.co/XjHl8z7yW9",79591,38295,17304,135190
452,Tarjeta de debito para barinas estado barinas,57404,75805,28838,162047
453,"Hola dr,  Dios los bendiga linda familiares, y bello pueblo Peribeca de nuestro Edo T√°chira, con ese calor humano de sus habitantes sencillos. https://t.co/dSXQC25jPU",73975,27152,39456,140583
454,"@1ra_cia_dcr53_1 CON M√ÅXIMO COMPROMISO PATRIO! üëäüáªüá™
#17Oct El MG Juvenal Fern√°ndez L√≥pez @GNBCmdtGral, realiz√≥ visita en el Comando de Zona @GNB41_CARABOBO acompa√±ado del Cmdte de Zona GB @Rivera_bastardo

#LaVerdadSiempreTriunfa
#PuebloYCEOFANBVenceremos https://t.co/jUUcJpybhF",33146,65077,43421,141644
455,me despert√© y me puse a escuchar a taylor mirando un punto fijo si esto no es terapia no s√© que es,1859,20018,73875,95752
456,Cicpc detuvo a un hombre en Carabobo por asesinar a su madre y lesionar a una beb√© https://t.co/KokiudY7pT,78459,48502,7242,134203
457,#Exclusivo | Bancos vender√°n los US$50 millones que inyectar√° el BCV al mismo precio del #29Sep https://t.co/zkMAtdCfSs\',67369,66522,42397,176288
458,"via VENVARIEDADES: Buenos d√≠as, ¬°Feliz S√°bado!
Pronostico del clima para #SanDiego el S√°bado 2/10/2021 #Carabobo #VenVariedades #Clima #2Oct   #BuenosDias #FelizDia #FelizSabado     
@sandiegovial
@SanDiegoVe https://t.co/wm88Y5JfNe #QuedateEnCasa",97688,35209,92783,225680
459,"Cuando un comercio cumple las normas hay que reconocerlo y aplaudirlo, la cadena de automercados LIDER en la isla de ARAGUA se gu√≠a por la tasa oficial del BCV y no por la locura CRIMINAL.",45604,17147,44393,107144
460,Mi solidaridad infinita con @churuguara. Una colega bien plantada. https://t.co/OkULfY5TVp,93079,28166,67319,188564
461,"@ParqueAviadores Kit Nintendo Dsi por 2$, incluye: 01 Lector de Tarjeta MicroSD, 03 Protector de Pantalla y 03 L√°pices punta de goma. #Nintendo #DSI #Game #Vende #VenVariedades #Carabobo #Valencia #SanDiego #mercadolibre https://t.co/HtqYnDG67t https://t.co/ij9bBtxylc",74421,95662,24742,194825
462,@RedRadioVe @BCV_ORG_VE Cada quien cobra el d√≥lar a presi√≥ que Leda la gana,63978,24950,98868,187796
463,"@BCV_ORG_VE Lo √∫nico que puede frenar al d√≥lar criminal es la indexacion de la econom√≠a con el petro y el bolivar digital, al indexae sueldos,salarios impuestos y pensiones se le da un jaque mate al dolar",36555,35144,75864,147563
464,"@eekhout_blanca Que Tal Camarada.? Tengo un proyecto de una UPF, para Harina de Maiz Precocida. Necesito me ayuden a concretarlo. Coro-Falcon. 04261010213 https://t.co/SwwryWkKTK",79807,31385,64590,175782
465,"Los d√≠as viernes en tachira yo escucho
#ReporteBernal 
@FreddyBernal 
@jefri_arguello 
@ClapmpioBolivar 
#SoyComunicadorClap https://t.co/zqUUynZxPV",55687,23237,7609,86533
466,"‚ö†Ô∏è‚òë‚òë‚òë #InformacionVial (06/10) #Carabobo Tr√°nsito fluido en ambos sentidos en la Autopista Regional del Centro, tramo #Carabobo, a la altura del kil√≥metro 122 (Viaducto La Cabrera). Info: @GNBunidad_vial #ARC #6Oct https://t.co/a1bubcCBRm",48907,4030,74376,127313
467,@FreddyBernal  candidato  a la Gobernaci√≥n  dl T√°chira  desarroll√≥ encuentro cn las autoridades dl norte d Santandr para pedir el flujo ordenado y bioseguridad  en la #Frontera  Colombo venezolana @dcabellor  @Juntosxtachira1  @arguelloyepfri @Juntosxtachira1 #soycomunicadorclap https://t.co/6eSnkJzrQg,53178,62438,48209,163825
468,"@ReporteYa @churuguara Y al Coqui? Le pr√©stamos el club para que disfrute, con sus panas.

Qu√© deseccion de pa√≠s.  

LIBERTAD PARA ESOS J√ìVENES YA! https://t.co/jPYQOsmd1O",43348,71521,78026,192895
469,"@endsequera Es un payaso que dice ser pol√≠tico, el  de creer que el de Carabobo es un √©xito",22358,8785,95355,126498
470,üëÆ‚Äç‚ôÇÔ∏èüöì MP anuncia detenci√≥n de presunto narcotraficante vinculado al cartel de Paraguan√° https://t.co/OgaCPsM2dd https://t.co/ZWsippu2Sy,50925,84475,83067,218467
471,"@NicolasMaduro Sin electricidad todo el sur este de Venezuela, desde Guasipati hasta Santa Elena de Uairen desde las 2:30pm el estado Bolivar, el estado que produce la electricidad de Venezuela, lo dejan sin el servicio a sus habitantes ademas sin gas ni gasolina desde hace meses",21072,53412,53163,127647
472,#SUCESOS Matan a hombre en el parcelamiento Santa Ana de Coro https://t.co/AGUSnDPUz1,24025,98335,51607,173967
473,"#16Oct hoy contamos en la  #GNBD411Carabobo del @GNB41_CARABOBO, con la visita de nuestro  @GNBCmdtGral, quien nos transmiti√≥ un saludo Patriota y Revolucionario enviado de nuestro CJ @NicolasMaduro #GNBCaraboboSeguro
 #JuntosSomosM√°s
#VenezuelaTieneConQu√© 
#GNB5taD411Carabobo https://t.co/Wu6kNoL20c",54835,27157,54834,136826
474,Ahora dicen q es culpa de los yankis,2058,83493,71724,157275
475,"@caraboboreporta Base Cooler para Mini Laptop de Aluminio con 2 Fan con Cable USB M/M para la conexi√≥n, 6$. Hacemos env√≠os nacionales #Cooler #Laptop #USB #Vende #TecnoAccesorio #Carabobo #Valencia #SanDiego #mercadolibre https://t.co/0yV832TgIE https://t.co/uv15HxILD8",25789,49656,44386,119831
476,"@NicolasMaduro Denunciamos p√∫blicamente a los Directores de las UTEC Carabobo, Lara, Nueva Esparta, Sucre, Zulia, as√≠ c√≥mo Directores del Nivel Central del Ministerio del Poder Popular para el  Ecosocialismo por el Acoso Laboral y las Suspensiones de Sueldo en contra del Personal https://t.co/r8oxX6nB8D",12800,33412,83443,129655
477,"El d√≥lar paralelo comienza la ma√±ana subiendo y empareja al BCV
https://t.co/o6KyWSyPpv",59107,8684,9404,77195
478,"Con representaci√≥n de la Academia de Historia del Norte Santander, Academia Santanderiana, Archivo General de la Naci√≥n, y nuestra representaci√≥n por la Universidad de Cundinamarca, ULA, HISULA UPTC, y Academia de Historia del T√°chira. https://t.co/yRDVJsFot3",2698,82958,46135,131791
479,"#DeInter√©s | Continuando con el Plan Cayapa, @Coboalavictoria, realiza Gesti√≥n de Cobro a Instituciones P√∫blicas de los municipios Bol√≠var y Ribas del estado #Aragua. #AndaYVac√∫nate #PorUnSeguroM√°sSocial @NicolasMaduro @MagaGutierrezV @ivssoficial https://t.co/Wq7ytSFphS",7791,99723,73604,181118
480,"@ELCOMPA33143158 Mi compadre @ELCOMPA33143158  me sorprende con el tama√±o de esas arepas.  Como caraque√±o las desconoc√≠a. Pero leo a tuiteros asegurar que son tradicionales en Falc√≥n, Sucre, Margarita y Tachira. Sobre todo para trabajadores del campo. ‚ÄúAS√ç SON LAS COSAS‚Ä¶‚Äù.",47400,9036,68482,124918
481,Y como saben ellos si uno actualiza o no,96938,44630,54837,196405
482,"Los colaboradores del estado bolivar,CDI Castillito, felicitamos el #Aniversario61CDR . #CubaPorLaSalud @AdanVillavicen5 @AnayansyPR @Cubacooperabol2 @cubacoperaven @CubaVa_Bolivar2 @KeylerING @Yordani12402517 @CdiCastillito @GHNordelo5 https://t.co/p2DDA24jNh",60188,44916,3282,108386
483,"üîé#OBUAlD√≠a Sin presupuesto comedores de la Universidad de Carabobo
https://t.co/xKOIbxpwwR v√≠a 
@diariolacalle

#OBUniversidades #Venezuela #MonitorOBU",57788,3020,74263,135071
484,"REFRINSURCA - PUNTO FIJO  (  REFRIGERACI√ìN  INDUSTRIAL SURAMERICA  C.A  )  REPUESTOS DE REFRIGERACI√ìN  DOMESTICA,  COMERCIAL,  INDUSTRIAL, AUTOMOTRIZ. TUBER√çAS, GASES  REFRIGERANTES, ASESOR√çAS  E INSTALACIONES  DE  EQUIPOS  INDUSTRIALES  DE  REFRIGERACI√ìN, CALIDAD AL MEJOR PRECIO https://t.co/m3evu6nZdG",6575,27715,23683,57973
485,¬øPor que no esta bien visto sentarse en una banca y mirar un punto fijo en el suelo durante los 15 min de descanso?,13447,7759,35658,56864
486,"#RT @seniat_falcon: RT @SENIAT_Oficial: #TalD√≠aComoHoy Muere Matea Bol√≠var nodriza del Padre de la Patria y Libertador Sim√≥n Bol√≠var, qui√©n se ocupo de su crianza y fue el pilar en la formaci√≥n de sus valores y principios. https://t.co/N6Y7qt2dr0",72151,85421,23172,180744
487,"@elpiojolopez @ReporteFalcon @vclarkb Que carae'tabla eres pana... tienen los 3 hospitales en Pto fijo de centilena q por cierto NO tienen NADA xq ni oxigeno tienen,las personas con otra patolog√≠a no saben a d√≥nde ir xq ir a una cl√≠nica es imposible x el costo d la consulta üò† acabaste con Todo .",20938,77881,9684,108503
488,"M√ÅXIMO COMPROMISO PATRIO! üëäüáªüá™ #17Oct üé• El MG Juvenal Fern√°ndez L√≥pez @GNBCmdtGral, realiz√≥ visita en el Comando de Zona @GNB41_CARABOBO acompa√±ado del Cmdte de Zona GB @Rivera_bastardo
#GNBPacvallado 
#LaVerdadSiempreTriunfa
#PuebloYCEOFANBVenceremos https://t.co/ACg32OEg5i",83407,2037,91554,176998
489,"@gonzaluo Es as√≠, existe un grupo de personas dentro y fuera del pa√≠s que elaboran un discurso de ""mejor√≠a"" eso es parte de un plan, el problema es reproducir de forma inconsciente ese discurso, el BCV disfraza las cifras del IPC, recordemos que el BCV no es independiente.",95520,32099,52319,179938
490,Zonas de Valencia y Naguanagua tienen 5 d√≠as sin agua https://t.co/D2ZwUCNCAu  aguaaaaaaa por favoooor,19448,20088,56652,96188
491,Les va a ir de maravilla en la pr√≥ximas elecciones al gobierno  despu√©s de semejante robo en el banco del pueblo,11465,12370,81437,105272
492,"@0800Bombona Esta solicitud se viene realizando desde hace cierto tiempo, se agradece su atenci√≥n a lo expuesto, la empresa gasfalca ya no quiere recibir los cilindros para recargas por defectuosos saludos, buen d√≠a.",55182,72497,32523,160202
493,"#InfoIAIM || A partir del 1 de octubre, las actuales piezas monetarias que est√°n en circulaci√≥n en Venezuela (Bs.10.000, Bs. 20.000, Bs. 50.000, Bs. 200.000, Bs. 500.000 y Bs. 1.000.000) se mantendr√°n hasta que lo determine el @BCV_ORG_VE. https://t.co/HHXdAAqd7z",22148,62971,2188,87307
494,@delcyrodriguezv debe realizar una rueda de prensa explicando que la tasa oficial es @BCV_ORG_VE ya que pondera el promedio de los principales banco del pa√≠s de la demanda de compra y venta del $. Los empresarios y comerciantes deben acatarla. #VacunateContraLaCovid19 @VTVcanal8,37041,24402,21879,83322
495,"#EnVideo Freddy Bernal, protector del estado T√°chira, estuvo presente en el momento en que se llevaban los contenedores del Puente Sim√≥n Bol√≠var. https://t.co/B1wGz6arBI",28303,670,4584,33557
496,@Tachira_Natural ¬øDe queso y guayaba?,61318,6223,7975,75516
497,@BcodeVenezuela Ya me han quitado 120 $ al cambio y la soluci√≥n que me dan es que pague el saldo negativo que ustedes mismos me colocaron‚Ä¶ Tenemos que hacer una DEMANDA MASIVA a este banco ladr√≥n!!! ¬øQui√©n se une? https://t.co/JOYhxFXYCS,33578,90249,25940,149767
498,"üö® Efectivos del @GNB41_CARABOBO Efectuar√≥n despliegue especial de Seguridad Ciudadana en el Municipio Puerto Cabello y Juan Jos√© Mora 
#GNB2daD412Carabobo
#2Oct  #CaraboboSeguro #2Oct CEOFANBAlertaPermanente
 PuebloyFANBInvictos
.@vladimirpadrino
.@GNBCmdteGral https://t.co/9MVNuSLatC",65029,96790,63667,225486
499,M√°s de 40 pacientes renales denunciaron que est√°n a punto de quedarse sin di√°lisis en T√°chira https://t.co/dLc74j6RTo,49444,99163,29413,178020
500,"Detuvieron en Carabobo a grupo dedicado a traficar con adolescentes para prostituirlos
https://t.co/dq6tQag7uC

Por üñäÔ∏è@RCamachoVzla",6831,33018,31697,71546
501,"@gonzalezjonat16 @tvnnoticias @TReporta Hola Javier, ¬øNos podr√≠as indicar si esperas nuestros servicios en la Zona Paga Interna Pedregal o Zona Paga Metro Pedregal?",87806,9173,85857,182836
502,@Banesco qu√© pasa con la aplicaci√≥n que no deja hacer pago m√≥vil,86568,46700,8189,141457
503,Daniel_RiosVE: ¬øC√≥mo fue asesinada Maya? Su cad√°ver no aparece y su esposo est√° tras las rejas https://t.co/tYvZ7w8HDT #DanielRiosTeInforma #GacetaCarabobo #Carabobo #Venezuela,96889,69783,48598,215270
504,"@VenezuelaSaime Buenos d√≠as, vi en las noticias sobre la inauguraci√≥n de una oficina en Zaraza estado Gu√°rico y la operatividad de las dem√°s oficinas a nivel nacional... Sres. Caicara del Orinoco, Mcpio Cede√±o estado Bol√≠var no funciona la oficina hace a√±os. Se requiere la...",64237,68238,40958,173433
505,@LaTeleTuya Saludos cordiales en total sinfon√≠a desde la ciudad de coro estado falc√≥n #CLUBHIPICOxTLT @mrodoficial @OficialINH Excelente Transmisi√≥n üáªüá™üì°üéßüì∫üõ∞Ô∏èüéôÔ∏èüêéüêéüêéüèÜüò∑,68320,19017,37324,124661
506,"Minpesca atiende solicitudes del sector en el estado Falc√≥n para fortalecer la producci√≥n

#16Abr

https://t.co/c2q0n7pcNu https://t.co/361Rlw4rAr",9420,66672,27900,103992
507,Saludos cordiales desde Coro Estado Falc√≥n @LaMagnifica25 Feliz viernes,27169,39752,5095,72016
508,"@mtscano @m_horno Estupendo art√≠culo e iniciativa, leer a veces es como transitar por un pedregal.",63149,85924,42523,191596
509,"Muy buenos d√≠as, feliz jueves 7 de octubre estamos presentando  a nuestros lectores la portada de la edici√≥n del diario La Calle. Busca la edici√≥n impresa en tu Kiosko favorito de Carabobo.

Adem√°s Visita nuestra p√°gina web https://t.co/Wnfy0ZK9RW https://t.co/9E1teClg4w",62969,42477,6334,111780
510,Detienen en Venezuela al l√≠der del poderoso cartel de Paraguan√° https://t.co/Chac1rxPPu,74054,74520,91377,239951
511,"""Consejo de Estado mantuvo la investidura del senador Gustavo Bol√≠var""
 https://t.co/27oaXCmM7Z",84184,11991,67330,163505
512,"üçñüçóü•© Este domingo, busca #ELPRECIODEHOY de carnes en nuestras sucursales de Margarita,  Cuman√° y Paraguan√°.
.
Por favor recuerda cumplir con nuestras medidas de bioseguridad. https://t.co/ynNSGfFZLk",76789,25350,14954,117093
513,"Ahora .@TRAKIenganchate va a incrementar el precio a los productos, ejemplo: si su precio era de 10$ ahora costar√° 15$, pero a la tasa del .@BCV_ORG_VE 
#Especulaci√≥n
#Indexaci√≥nSalarialYa
.@NicolasMaduro @delcyrodriguezv https://t.co/hQ83P3S1BG",31458,50306,65208,146972
514,"@SeleVinotinto No Joda!!, en el Polideportivo del Tachira üü°‚ö´ si lo Recibimos en casa no importa contra quien Juegue!!! Siempre sera nuestra Vinotinto...",63763,97243,60143,221149
515,"Acaba de publicar una foto en Punto Fijo, Estado Falc√≥n, Venezuela https://t.co/VThGYvP9WV",3572,83641,42002,129215
516,"@AssConcerned @tariqnasheed It wouldn't come close to the amount of deaths whites cause around the world, against other whites and non-whites, literally wipe out the mayans, taino/arawak indians, aboriginal australians, so it's not even close.",79488,6819,77937,164244
517,Correcci√≥n de fugas en aducci√≥n Isiro-Las Calderas mejora suministro en Colina https://t.co/NVwE1zuipH,55962,67132,51529,174623
518,Alguna mujer atrevida por la av pedregal o la colonia Guadalupe,45520,14580,84123,144223
519,Oye pues la serie de  Falcon y el Soldado de Invierno no ha estado mal. Al menos ver√© la segunda temporada cuando salga. #FalconAndWinterSoldierFinale,45573,94335,33092,173000
520,"#ATENCI√ìN üî¥

No permitamos atropellos contra nuestro pueblo, denuncie la especulaci√≥n por parte de comerciantes que usen tasas superiores a las del @BCV_ORG_VE.

¬°Denuncia al Especulador! ‚òù

#LaCalidadEsVida https://t.co/URHqZmubIU",88119,13965,50017,152101
521,En #Carabobo Diagn√≥stico en materia de #Salubridad Le√≠do v√≠a (Red de Medios / Agencias) #Gesti√≥n | Afirma Armando Amengual: ¬´La crisis sanitaria no puede seguir siendo manejada por alguien que se ha contagiado 4 veces de Covid¬ª https://t.co/bWOpmSlCe0 #ACANoticias,16813,6202,13989,37004
522,Fan destacadoRumbo a la victoria ,8526,94028,2276,104830
523,"@GNB41_CARABOBO @MinpublicoVE @libertad003 @PrensaCmdteGral #18Oct Seguiremos Protegiendo al Pueblo #GNBDAmacuro #CEOFANBPorVzla
#EpaVamosACuidarnos
PuebloUnidoYGNBVictoriosos
.@libertad003
.@PrensaCmdteGral",19330,81934,2743,104007
524,#Sucesos | EN CARABOBO: Asesin√≥ a su madre en medio de una discusi√≥n y tambi√©n lesion√≥ a una beb√© https://t.co/KokiudY7pT,92487,16816,31808,141111
525,"Lamentablemente no podemos. Ocurre que la ‚Äúverdad‚Äù es bastante escurridiza. No es un punto fijo con coordenadas concretas. Es un ideal al que s√≥lo es posible aproximarse mediante el an√°lisis de la realidad que es distinta a la verdad, y por a√±adidura a menudo bastante compleja &gt;",18272,7942,76832,103046
526,#AndInVenezuela BCV actualiza precio del d√≥lar oficial hasta el #11Oct (+Monitor). https://t.co/XaEcVHl7nS,78898,93322,92027,264247
527,"#municipioValencia se realiza Despliegue Operacional de Seguridad Ciudadana y el Sistema Integrado Carabobo participa con 55 funcionarios, 2 veh√≠culos de rescate, 9 motos y 3 ambulancias #SOLOQUEREMOSSALVARVIDAS https://t.co/pAZwQUSR3M",42255,58263,55263,155781
528,@VenezuelaSaime En San Antonio del T√°chira el.proximo jueves puedo renovar mi c√©dula?,57047,29187,22800,109034
529,Junto a nuestro pr√≥ximo gobernador @amarcanopsuv y @OviedoPSUV @AlcaldiaCaroni sostuvimos encuentro con las autoridades Pequiven @TellecheaRuiz para fortalecer  los productores del estado Bol√≠var https://t.co/e0gtRczdvH,64136,93641,85906,243683
530,"CON M√ÅXIMO COMPROMISO PATRIO! üëäüáªüá™
#17Oct üé• El MG Juvenal Fern√°ndez L√≥pez @GNBCmdtGral, realiz√≥ visita en el Comando de Zona @GNB41_CARABOBO acompa√±ado del Cmdte de Zona GB @Rivera_bastardo.
#GNBCVC 
#LaVerdadSiempreTriunfa
#PuebloYCEOFANBVenceremos https://t.co/Ysd9RcWnEG",22995,80055,22769,125819
531,"@angelaincerti All√≠ mismo en El Pedregal barrio de Chacao hicieron una quema de Judas, mucha gente asisti√≥ y a nadie se le vio mascarilla",9004,93021,99884,201909
532,"@RossMarapacuto Te invito a paraguana.. Podemos ir a adicora, buchuaco, el supi, villa marina etc.. Aqu√≠ hay playas para escojer",99096,34062,4314,137472
533,"Nuestros Centinelas del .@GNB41_CARABOBO se mantienen desplegados a lo largo y ancho del estado #CARABOBO trabajando en pro del bienestar del pueblo. #CaraboboSeguro #7Oct #CEOFANBPorVzla
#ChavismoVictoriaPerfecta
#GNB5taD411Carabobo
PuebloYGNBVictoriosos
.@libertad003 https://t.co/BmfRogVrKa",62301,9868,98078,170247
534,#20Oct Nuestra #MiliciaBolivariana esta en todos los √°mbitos para defender lo indefendible. @maduro_en @vladimirpadrino @wistohor @ZODI45_Carabobo @CMRediC @Apdi_losguayos https://t.co/CKBewiUQOm,30388,32545,34602,97535
535,"#16Oct Desde el sector Campesino, V√≠a el Pao, Km5-6 Parroquia Dalla Costa en compa√±√≠a de Agricultores y campesinos, Apoyamos a nuestro C√°marada y l√≠der de la clase obrera @amarcanopsuv, Pr√≥ximo Gobernador del Estado Bol√≠var  #JuntosSomosMas",28664,31338,17242,77244
536,"Este #28Oct inicia el XV Festival Mundial de Poes√≠a de Venezuelaüáªüá™ en honor a ùêÄùêßùê≠ùê®ùêßùê¢ùê® ùêìùê´ùêÆùê£ùê¢ùê•ùê•ùê®.
Evento que reunir√° de manera virtual 5 continentes en el grito libertario de Carabobo a 199 a√±os del poema ""Mi Delirio Sobre el Chimborazo"" del Libertador Sim√≥n Bol√≠var. https://t.co/Spc3MeEk7z",24471,82253,42674,149398
537,Y aun as√≠ los politiqueros cohabitadores quieren ir a elecciones como si eso solucionaran los problemas q nos aquejan en el T√°chira. https://t.co/lzo484J9RT,95429,56429,29210,181068
538,"Exhorta banco de sangre a la donaci√≥n altruista
https://t.co/6mpy0clLq3
#PiedrasNegras #BancoDeSangre https://t.co/LScMLdlcxM",23555,9782,2833,36170
539,"#DeInter√©s üìÉ #GNB y @sundde_ve supervisan comercios en el estado Bol√≠var.

Noticia ‚û°Ô∏èhttps://t.co/hs5YdBoY5H

#6Oct CEOFANBPorLaPatria
#Producci√≥nEnMarcha
#GNBBol√≠var
 #GNB1ERADESURBOLIVAR PuebloyFANBInvencibles
.@vladimirpadrino
.@GNBCmdtGral
https://t.co/fgXBc8mxNV",97709,8826,93759,200294
540,"@fenegasvenezue1 Los peligros de la gasolina y el gasoil artesanal que producen en Falc√≥n
 https://t.co/htAb1unuY8",12449,5147,58591,76187
541,@RedRadioVe @BCV_ORG_VE C√≥mo as√≠ entre ellos mismos. Si hay plata roja rojita,19796,99889,16512,136197
542,@LdAlejandro @ErikaOSanoja @planwac @BcodeVenezuela C√≥mo siempre debi√≥ ser. Ya es hora,9430,5765,90273,105468
543,"#RT @FreddyBernal: Como un solo equipo, la comunidad organizada de #Zorca, la Alcald√≠a de C√°rdenas, Capacho Nuevo y el Protectorado seguiremos sirviendo y dando respuestas r√°pidas para el buen vivir de nuestro pueblo del #T√°chira. ¬°Junt‚≠ês seguiremos ‚Ä¶ https://t.co/obd5GTNSsv",72568,65443,70086,208097
544,"Este caballero es Leandro Dom√≠nguez, aspirante a la alcald√≠a del Municipio Libertador, en el Estado Carabobo. Si, el mismo que se abomb√≥ con botox la boca para darle a sus adversarios ""la mama, de la mama(das). Qu√© falta de respeto con los electores de Carabobo. https://t.co/LYZclPsT45",59905,1280,56193,117378
545,"CDI Coviaguard Estado Bol√≠var
Las Misiones Sociales Cubanas en Venezuela festejando el 61 Aniversario de los 
CDR. #Aniversario61CDR 
@cubacooperaven 
@CubsSabanaOdont
@Cubacooperabol2 https://t.co/6RG9oyT5LC",24983,14199,94783,133965
546,Hallan el cuerpo de vigilante en avanzado estado de descomposici√≥n en Punto Fijo https://t.co/ceB5EnICMP *,78960,78855,8222,166037
547,D√≥nde? Yo hoy sal√≠ a comprar y afortunadamente nada subi√≥ de precio y el $ estaba al precio BCV . https://t.co/h7tBMdVf71,15010,28074,15754,58838
548,"Efectivos del @GNB_ColonD213, efectuaron la detenci√≥n de 1 cddno, quien se encuentra solicitado ante el Tribunal Militar Noveno de Control de Punto Fijo. #19Abr 
#FANB #GNB
#AbrilDeFuegoPatrio
#GNByPuebloLeal
.@cmdtegralgnb
.@GNBGDjuvenal
.@LopezvargasR https://t.co/H9BI49JAV4",67465,9765,90788,168018
549,"El .@FalconGnbcz mantiene despliegue en el territorio Falconiano, para garantizar la seguridad y la salud del pueblo. #11Abr #FANB #GNB
#Rebeld√≠aBicentenaria
#GNByPuebloUnido
#YoSoyFANB
.@NicolasMaduro 
.@cmdtegralgnb
.@GNBGDjuvenal
.@LopezvargasR https://t.co/yuDFtgQspF",66914,70181,16217,153312
550,"@Yumaryb @avilaelguerrero @lacava10 @alimentoscarabo @mazo4f @la_iguanatv @Defensoria_Vzla Hice reclamo en ALIMCA (alimentos Carabobo), empresa que distribuye los CLAP y estoy esperando respuesta. Basta de atropellos @avilaelguerrero @alimentoscarabo @rafaellacava10  @YunnelysP",44206,60180,22502,126888
551,"Daniel_RiosVE: La Justicia de #Per√∫ pidi√≥ que el embajador peruano designado para #Venezuela, no salga del pa√≠s por una investigaci√≥n sobre blanqueo de capitales.

Una joyita quieren mandar para Venezuela. 

#DanielRios https://t.co/BsHL9KNOBC #Carabobo",42462,22995,70948,136405
552,"Centinelas Permanentes de la #GNBFalc√≥n se mantienen comprometidos en garantizar la Protecci√≥n y Bienestar de nuestro pueblo. 
#11Abr #FANB 
#Rebeld√≠aBicentenaria
#GNByPuebloUnido
#YoSoyFANB
.@NicolasMaduro 
.@cmdtegralgnb
.@GNBGDjuvenal
.@LopezvargasR
 https://t.co/DvxTBG4Eck",97044,54307,82874,234225
553,"Le pregunt√© a mi vieja si cuando muri√≥ mi bisabuela me dijeron y me respondi√≥ que s√≠. Le dije que no tengo recuerdo de que lo hayan hecho, literalmente no s√© cu√°ndo muri√≥ y creo que le arruin√© el fin de semana porque se qued√≥ mirando un punto fijo. https://t.co/RYe1eRwNHC",18165,30873,58135,107173
554,Kobalqui la plata parada 2 d√≠as weon ,75983,78976,52097,207056
555,Maestro de maestros . QEPD....,85592,16940,49291,151823
556,"¬°Sin Tregua! Durante allanamiento en el sector de Rana de Oro, Pedregal, uniformados de @protegeryservir detienen a dos personas solicitadas por el delito contra la libertad (Secuestro) y contra la vida y la integridad Personal. Adem√°s se decomis√≥n un arma de fuego y droga. https://t.co/ObhlTyfiBn",77787,7717,9954,95458
557,"UTNC alista aplicaci√≥n de su primero de dos ex√°menes de admisi√≥n
https://t.co/wbgOUacnV0
#PiedrasNegras #Educaci√≥n https://t.co/9VieCrnsb3",67381,6820,97833,172034
558,"@HIDROFALCON Porque a los sectores 6,7y8 no nos llega y sin decir qu√© cuando llegaba era a una casa si a otra no",62590,40551,16016,119157
559,"@FTB_falconia @MitsubaKrt ÂçÅÂàÜÈÄü„ÅÑ„Å®ÊÄù„ÅÜ„ÅûÔΩ•ÔΩ•ÔΩ•
ÁèæÂú®ÁÆóÂá∫„Åï„Çå„Å¶„ÅÑ„ÇãË∑ùÈõ¢„Å´ÂΩì„Å¶„ÅØ„ÇÅ„Çã„Å®„ÄÅ„Ç¢„É≥„Éâ„É≠„É°„ÉÄÈäÄÊ≤≥„Åæ„Åß3ÔΩû4„É∂Êúà„Åè„Çâ„ÅÑ„Å†„Åã„ÇâÈäÄÊ≤≥ÈñìÁßªÂãï„ÇÇÂçÅÂàÜÊÉ≥ÂÆöÂèØËÉΩ„Å™„É¨„Éô„É´„ÄÇ
„ÇÄ„Åó„ÇçÈÄü„Åô„Åé„Å¶ÂÜÖÂÆáÂÆôÁßªÂãï„Å´„ÅØ‰∏çÂêë„Åç„Åò„ÇÉÔΩ•ÔΩ•ÔΩ•",42402,77064,71288,190754
560,"@ALopez_Ortega Ten√≠a yo como 23 a√±os viajabamos mucho y conoci parte de Coro y Punto Fijo, conoc√≠ una playa q le dicen la punta, otras q se me olvida los nombres pero el mar es muy denso, y en los m√©danos hay playitaüòçüòçüòçüòçüòçüòçüòç",43389,40506,50189,134084
561,"@RomanSastre @AlejandroCambr_ @garciabanchs Yo tampoco creo en cerrar el BCV, creo que hay que dejar de usarlo para que desaparezca‚Ä¶ es la instituci√≥n m√°s da√±ina despu√©s del Seniat, que tambi√©n debe desaparecer‚Ä¶

Dejar de usar el Bol√≠var y cualquier otra moneda controlada por un estado‚Ä¶ acaba con la inflaci√≥n‚Ä¶",4753,66819,29176,100748
562,Vuelos nacionales se reanudan excepto en Bol√≠var y T√°chira https://t.co/nzWQWd6d32 v√≠a @DiarioPrimicia,57530,5110,82991,145631
563,@WalterDossier @VTVcanal8 @jorgerpsuv @Mippcivzla @luisreyes1000 Buscamos PERIODISTAS contrato 1 a√±o para informar de las oportunidades AGROPECUARIAS en BOLSAS DE VALORES FINANCIERAS     https://t.co/CdjJPBocBq @CNPCaracas @cnpven  @cnpzulia @Cnp_Lara  @CnpMiranda @CNP_Carabobo  @economia_gv @mmartinez_gv @sntpvenezuela @globovision @UNoticias,39330,84851,39494,163675
564,"#11Sep #T√°chira #Accidentes
@ingmaryrodrigu1: al menos cuatro accidentes de tr√°nsito han ocurrido en #SanCrist√≥bal este s√°bado.
Brigada Motorizada prestando atenci√≥n prehospitalaria a los heridos. https://t.co/KBOMFoqk38",82803,1578,36230,120611
565,"@ClaraGrima Y en Tenerife existe la calle Punto Fijo üò¨üò¨

Calle Punto Fijo
https://t.co/25fJs7rZsv",22134,17568,28740,68442
566,"Victoria para el pana @HeribertMartin2 
üôåüôåüôå
Del sector Las Malvinas en Sabana Larga, municipio Colina del estado Falc√≥n.
Felicitaciones tercioooo
üèáüèáüèáüèá https://t.co/eHFiLU8nnd",1899,41581,94696,138176
567,@jmarther @Cauribel90 @rmfinanzas @BcodeVenezuela Ser√° que la Junta Directiva se har√° igualmente de ‚ÄúO√≠dos Sordos‚Äù como cuando miles les escrib√≠amos de lo malo del servicio Web del Banco? Quien no aprende repite la lecci√≥n. Busquen gente con Formaci√≥n profesional y Talento y sedan los cargos. As√≠ quedar√°n mejor porque van mal...,1857,34746,62824,99427
568,"@CantvContacto Sin internet num.02122380360 deuda pagada v√≠a Banesco online d√≠a 29/10/2021 ( 12,30),se llama a numeros para reactivar servicio no atienden,se escribe por Instagram y es igual no dan respuesta o cuentas suspendidas",17894,42097,99841,159832
569,"@NOTIFALCON Que HDP tan irresponsable, da pena ajena, ojal√° los ignorantes no se tiren por ese abismo. Le van a dar cancha al Corona virus para que se siga esparciendo. Increible pero cierto",25527,11651,40565,77743
570,#25Oct | BCV inyectar√° m√°s divisas en efectivo al mercado cambiario para contener el d√≥lar https://t.co/KxyGJEaYRX,73872,20742,86971,181585
571,Conozca el precio del d√≥lar del BCV este 27 de octubre de 2021 https://t.co/V1KcczMfKt,85658,65280,59482,210420
572,"@BcodeVenezuela Sres Banco de Venezuela, desde que abr√≠ la cuenta BdvDigital no he podido sacar mis coordenadas, siempre da error. Que se debe hacer???",39554,5142,94919,139615
573,Ya tienen a la ni√±a como cartel de propaganda!!!estos del gobierno no pierden tiempo...!,25282,29326,1679,56287
574,@Compania531 @GNBCmdtGral @GNB41_CARABOBO @Rivera_bastardo Excelente,37515,76315,94342,208172
575,"@Noticia_tachira @PartidoPSUV @GustavoporSC Demasiado mal lo q hizo el tal flores haciendo v√≠deos de tik tok muy valiente irse para all√°. Pero no lo visto en la autopista la fr√≠a en el parque metropolitano, tampoco en los botaderos de agua en la calles  responsabilidad del inexistente @hidrosuroeste .",46827,46114,79998,172939
576,"@EEscarano Buenas noches, me gustaria que en tu plan de gobierno tomaras en cuenta la situaci√≥n del agua potable en carabobo, haciendo seguimiento muy cerrado al tratamiento del agua en la planta potabilizadora Alejo Zuluaga y el agua llega sucia en todo el estado",16513,58549,20629,95691
577,#NACIONALES Saime retoma hoy cedulaci√≥n a menores y entrega de documentos https://t.co/M5pdt8ggEZ,30626,66079,69320,166025
578,@RTP_CiudadDeMex la 123-A Pedregal de San Nicol√°s a Metro Universidad,13724,22492,38440,74656
579,@PresidencialVen Los maestros del Estado Bol√≠var queremos que nos cancelen las deudas pendientes y nuestras quincenas al d√≠a. Hasta cu√°ndo tanta burla para los maestros. El sr Gobernador brilla por su ausencia. Cancelen deudas pendiente y pagos al d√≠a.,29864,5245,874,35983
580,"La MUD cuenta con la militancia adeca quien ha estado desplegado por todo #Carabobo llamando a votar este #21, en #Naguanagua la unidad junto a @PanchoPerezLugo va con todo! https://t.co/2wRY7iXZt3",92126,3825,54248,150199
581,"Igual que Petro, Bol√≠var, √Ångela Robledo y dem√°s seres despreciables de extrema izquierda. Son populistas, pero viven como mantenidos a cargo del Estado @petrogustavo @angelamrobledo @GustavoBolivar https://t.co/KssOtcYWfp",57315,81879,86933,226127
582,"@CorpoelecInfo Municipio Guacara, Ciudad Alianza, Edo Carabobo.4ta etapa manzana 41 y 42. N√∫mero de contrato 1000079919326 n√∫mero tel√©fono 0426-4068373. Somos varias viviendas afectadas hace tres d√≠as estamos unas casas sin luz y otras solamente con la mitad de la casa con electricidad.",40969,32312,1551,74832
583,"Hoy estuvimos en Los Jardines, sur de #Valencia, donde los vecinos elevaron su voz ante la desidia que viven. 

Calles deterioradas, cloacas, falta de agua fueron algunos de los problemas.

Esta es la realidad que vive Carabobo, unidos recuperaremos lo que han da√±ado y olvidado. https://t.co/daJ7rxKcDG",55822,393,86283,142498
584,@jesuslopez23 Saludos cordiales en total sintonia desde la ciudad de Coro estado Falc√≥n #SuperLiga #HERGLAxMTV #SEPRENDIOxMTV @JJuniorCordero @javierparrac_ @MeridianoTV üòâü§óüëçüáªüá™üèÄüí™üì°üõ∞Ô∏èüì∫‚úåÔ∏èüëèüéßüéôÔ∏èüôè,18650,32274,13505,64429
585,"En perfecta union c√≠vico militar policial todos y todas en la defensa integral del territorio Patrio.
@NicolasMaduro @vladimirpadrino @dhernandezlarez  @Milicia_B1 @libertad003 @PrensaFANB 
@REDICentral_  @ZODI45_Carabobo https://t.co/O8W0b6MwXY",39580,82689,48526,170795
586,"@rmapalacios La gasolina importada es subsidiada por el fondo de estabilizacion, todos pagamos a la empresa privada asi mantenga su rentabilidad",65782,1375,87294,154451
587,"Contrastes de Falc√≥n, M√©danos de #Coro. Esto es Venezuela üáªüá™. Tierra bendita üåûüí• https://t.co/L0uRPdmdj6",99910,22612,23608,146130
588,"@Cubacooperabol2 
CDI SIMON BOLIVAR PEDRAZA
ESTADO BARINAS
#TENEMOSMEMORIA https://t.co/Cha4pJpF8u",86871,44463,74073,205407
589,"En honor a Ribas y la #JuventudBicentenaria, el Consejo Politico-Acad√©mico del @PartidoPSUV organiza el inicio de procesos formativos con instrucciones del Vice-Presidente de Formaci√≥n @HectoRodriguez y Territorial Lara-Falc√≥n V√≠ctor Clark coordinados por @Jlchpsuv
@NicolasMaduro https://t.co/1lymiBsHqC",14247,74760,18140,107147
590,#Barinas Asegura candidato a alcalde: Obispos clama por reparaci√≥n de vialidad y combustible https://t.co/55qGykZfD7 v√≠a @resumen_digital,81573,56370,82447,220390
591,"@Hidrocentro2011 üîµ#10Oct | #Domingo  #AHORA 11:38am SEGUIMOS #SinAgua en #LaIsabelica, #Valencia #Carabobo 
¬øY el #Agua pa cuando?
¬øC√≥mo vamos a prevenir
#Covid_19?
Que √±ema con √©stos incompetentes 
#SimulacroElectoral
#ATENCI√ìN
.@Hidrocentro2011
.@MPPAAguas
.@rafaellacava10 
.@EvelynBVasquez",36860,78149,53068,168077
592,"El saldo tras la aspersi√≥n con glifosato: campesinos quebrados y sin alternativas en regiones como el sur de Bol√≠var y Putumayo, desconfianza hacia el Estado, problemas ambientales y de salud: 

https://t.co/mTkkaERJY4",43439,47265,75843,166547
593,"@RobertoStekman5 @PoleoRafael El siglo XX venezolano fue marcado por dos grandes partidos pol√≠ticos, que nos sacaron de una Venezuela atrasada y anclada en el siglo XIX. Hay dos libros que me gustan mucho de historia pol√≠tica, uno de Carabobo a Punto Fijo de Caldera y otro de Manuel Caballero.",4780,39622,7359,51761
594,"@CDominguesP AL√ì?? üìû‚òéüìû‚òéüìû ES LA PIZZER√çA DE SAN CRIST√ìBAL? üíõüñ§ PED√ç UNA PIZZA üçïüçïüçï DEL TAMA√ëO DEL DVO TACHIRA ü§èüèªü§èüèªü§èüèªY ME ENTREGARON üõµüì¶üõµüì¶üõµüì¶ UNA ACEITUNA üò±üò±üò±

HAHAHAHAHAHAHAHAHAHAHA ‚ò†Ô∏è‚ò†Ô∏è‚ò†Ô∏è‚ò†Ô∏è‚ò†Ô∏è‚ò†Ô∏è‚ò†Ô∏è‚ò†Ô∏è‚ò†Ô∏è‚ò†Ô∏è‚ò†Ô∏è",66395,14497,14848,95740
595,"@BluRadioCo Pese a que el Consejo de Estado determin√≥ que el Senador Gustavo Bol√≠var no cometi√≥ falta alguna, Blu Radio opina de manera contraria. Son ustedes un medio informativo o de opini√≥n parcializada?",32836,835,73417,107088
596,"#QhuboTV |¬°RECONSTRUCCI√ìN DE AULAS EN ESCUELA!  
Siete aulas han comenzado a ser totalmente reconstruidas, adem√°s se construir√° un m√≥dulo de ba√±os y edificar√° una cancha multiusos, en el CEB Rep√∫blica del Per√∫ en la Colonia El Pedregal de Comayag√ºela, inform√≥ SEDECOAS. https://t.co/1YblKcYGAn",82690,59478,25920,168088
597,".@FreddyBernal: Logra acuerdo desde San Antonio del T√°chira para la apertura de la frontera y lo sella con un apret√≥n de manos y un buen caf√©
#FreddyAbreFronteras
üíõüñ§‚ù§Ô∏è

@NicolasMaduro @IvanDuque @delcyrodriguezv @Juntosxtachira1 @arguelloyepfri @Silfredo_Z @dcabellor https://t.co/GzGF0Xv1eV",42707,50771,30819,124297
598,@YoUsoMiNasobuco @AsesinaEsponja ES QUE HOY ME CAY√ì ATR√ÄS UN PAJUSO CON UN SOMBRERO Y FUE MUY RARO LOSIENTO,25646,18559,44061,88266
599,carro oficial cargando licor y contrabando donde vive Director de Loter√≠a del T√°chira colocado por la Gobernadora @laidygomezfespero pueda investigar y solicitar que el Presidente de la Loter√≠a 4147053874 debe corrobora la informaci√≥n y de la cara por mala actuaci√≥n de Alacr√°na https://t.co/6rdUJDJjOW,33247,4662,81661,119570
600,"Referente a la compra de tierras de Uribe, por q m√°s bien no se recuperan las tierras improductivas de algunas comunidades ind√≠genas y de paso el hotel de Bolivar ya q est√° en quiebra el estado lo puede volver productivo. Pienso yo",64714,48545,46442,159701
601,"La referencia a la discriminaci√≥n racial por parte de la polic√≠a estadounidense en el segundo cap√≠tulo de The Falcon and The Winter Soldier es BRUTAL! piel de gallina en toda esa escena, tremenda! #FalconAndWinterSoldier",49490,30417,791,80698
602,@NASAEarth Toda esa parte pertenece a falc√≥n y a Paraguan√°,49763,82696,43106,175565
603,"El 9/12/2020, 3 veh√≠culos de la DGCIM interceptaron a el ahora preso pol√≠tico Francisco Pacheco mientras se trasladaba por el estado Carabobo para visitar a su hermano. Francisco fue detenido y subido violentamente a uno de los veh√≠culos.
#LiberenAPacheco",99160,50217,78893,228270
604,Aja y cuando me regresan el dinero debitado? Y para colmo anoche me volvieron a hacer un descuento de una supuesta recarga.... Hasta cu√°ndo roban al pobre ? Cuerda de ladrones ,36159,67475,97037,200671
605,"@AlbertoRodNews En especial en el estado Bol√≠var, me imagino!!!",70603,9135,55133,134871
606,"ATENCI√ìN: üîäüîäüîä

Hemos puesto en conocimiento del Fondo Adaptaci√≥n el mal estado en que se encuentra la v√≠a de acceso al Puente Roncador. La entidad nos manifiesta una pronta soluci√≥n en los pr√≥ximos d√≠as. 

#MasCercaDeTi #Magangu√© #Bol√≠var https://t.co/9OPzgcLm9k",69335,81702,78557,229594
607,"#Sucesos | OVV: Bol√≠var se ubica en el segundo lugar como estado m√°s violento del pa√≠s
https://t.co/3c5nihDJuh",92346,76082,37166,205594
608,"@ReneJSuarez As√≠ est√° todo el pa√≠s. En el caso del estado Bol√≠var es para llorar, cuenta con dos r√≠os s√∫per caudalosos y el problema del agua es brutal. D√≠game la electricidad y la recolecci√≥n de basura. Pa' cagarse...",40709,52396,91134,184239
609,@2001OnLine Buscamos PERIODISTAS contrato 1 a√±o para informar de las oportunidades AGROPECUARIAS en BOLSAS DE VALORES FINANCIERAS @PartidoPSUV @Mippcivzla  @CNPCaracas @cnpven  @cnpzulia @Cnp_Lara  @CnpMiranda @CNP_Carabobo  @economia_gv @mmartinez_gv @sntpvenezuela  https://t.co/qYjcHIUlES,48478,62807,49347,160632
610,Hallan el cuerpo de vigilante en avanzado estado de descomposici√≥n en en Punto Fijo https://t.co/ADFnT4WYQC,86974,94505,956,182435
611,"@BcodeVenezuela La consulta es cobrada. Para eso me meto en la p√°gina del banco y hago la  consulta normal. No quieren nada, pues.",32313,21073,95210,148596
612,@DobleseSays Chichiriviche es m√°s cerca,2731,23419,42030,68180
613,@AnthonyLaser8 SRES AS√ç ES QUE TIENE QUE SER CUAL ES EL ENTE RECTOR DEL MOVIMIENTO DE DIVISAS Y DEL DINERO EN VENEZUELA ES EL BCV NO UNA PAGINA FICTICIA QUE A LAS 9AM Y A LA 1 PM PARALIZABA EL PA√çS Y LOS COMERCIANTES SE DEJAN LLEVAR POR EST√Å P√ÅGINA PARA PONER LOS PRECIO COMO A ELLOS LEDELAGANA,60543,72574,10296,143413
614,"@ConchisEspinoz2 @FelipeCalderon En 2007 el gobierno del Felipito erog√≥ 65 mil 100 millones de pesos para subsidiar y contener el aumento del precio de las gasolinas; al a√±o siguiente desembols√≥ 299 mil 300 millones de pesos. Dinero tirado a la basura (Dinero robado, ya que la gasolina jam√°s ha sido subsidiada).",51736,81653,62701,196090
615,"URGENTE ayuden a DENUNCIAR esto
@AcProcoyoacan @coylavoz @CoyoacanAsocCH @VPedregal3915 @PedregalesCoyo  @lajornadaonline  @reformaciudad 
#NoAMegaconstrucci√≥n  
#Perif√©ricoSur 
Predio 5178 Pedregal de Carrasco #Coyoac√°n denunciado a Presidencia 11-8-2020 NO HAY RESPUESTA üëá https://t.co/z0v7pMGOgt",61641,89067,20196,170904
616,"Pero los que esperan al Se√±or tendr√°n nuevas fuerzas; levantar√°n alas como las √°guilas; correr√°n, y no se cansar√°n; caminar√°n, y no se fatigar√°n. Isa√≠as 40:31

#Lunes #06Sep #T√°chira #SanCrist√≥bal",96271,79082,46841,222194
617,Presidente de Hidrocentro: Trabajamos para restablecer este viernes el suministro de agua en norte de Valencia https://t.co/uRWaaQcrm2,32774,89526,60097,182397
618,"üîµ #AHORA | ‚Ä¢ @hidrosuroeste informa:  suspensi√≥n del servicio de agua potable a partir de las 12:00 m, en los 13 mcpios.#T√°chira por aver√≠a presentada en el Mcpio. Sucre,La empresa de la regi√≥n activa de forma inmediata al personal t√©cnico,operativo, obrero y de maquinaria(2/2) https://t.co/Fo2vJClybi",7027,12688,96908,116623
619,@MaoliReveur @PazavilaM Sra paz soy un ni√±o con autismo de 13 a√±os vivimos en coro falcon ayudemos por favor a recibir ayuda como la recibe usted,91651,32141,39831,163623
620,"#14OctüìçEfectivos del @GNB41_CARABOBO, realizan la Aprehensi√≥n de un (01) Cddno solicitado por el Delito de Hurto Gen√©rico. #GNBCaraboboSeguro  #PuebloyCEOFANBEsPaz
#Soberan√≠aPatriayPaz 
CentinelasPorLaPatria
#GNBD411Carabobo 
.@PrensaCmdteGral https://t.co/w8yxcmLgoy",24535,13125,50020,87680
621,"Pr√≥ximos partidos de grupo occidental: 

üìå Deportivo Tachira Vs Zulia FC
üìå Estu M√©rida Vs Hermano Colmenarez
üìå Zamora FC Vs Trujillanos FC 

üò¥ Descansa: Portuguesa FC https://t.co/DrHAdFR9FS",90316,58944,29799,179059
622,"@Ivana_lc A cuidarse del paludismo, dengue, zika, chikungunya, fiebre amarilla, entre otras en el estado Bol√≠var. üò∞üò≠A comprarse un mosquitero.",44076,81757,26286,152119
623,"@BCV_ORG_VE si eres el regente el gu√≠a d Venezuela como se deb cobrar al cambio dl d√≥lar como lo dice BCV y la mayor√≠a d los comercios lo implementan al paralelo, cuando el BCV est√° alto se Gu√≠an x all√≠ pero cuando s lo contrario ABUSAN suben los productos en $ y Bs pero no Bajan",79397,37636,13608,130641
624,"Denuncia hoy fui a pagar @Intercable_Vzla y estaban recibiendo el $ a 4 mil le exig√≠ a la se√±ora que eso era ilegal porque es lo que marca el BCV 4,17 y me dijo que me fuera a pagar en otra parte y de paso me paso la tarjeta por 7,53 bol√≠vares de mas, y tampoco me llego el texto https://t.co/qcV5PtyFLS",62108,18833,51063,132004
625,"Acaba de publicar una foto en La Grita, Tachira, Venezuela https://t.co/GMHLczCJy0",15908,25971,57189,99068
626,"@chavistaganadr Lo que hicieron fue,equipara el costo incrementando el precio en $ BCV",16146,14130,59430,89706
627,"Los colaboradores cubanos de la salud basti√≥n de la Revoluci√≥n Cubana.Legado de los h√©roes de la Patria. Solidarios y humanistas por principios. 
CDI Orlando Araujo, municipio Bol√≠var, Estado Barinas
#H√©roesDeLaSalud @cubacooperaven
@CubacooperaveB6 https://t.co/JNX5EBP12l",19246,16268,69763,105277
628,"Dispositivo de Bloqueo en todo el territorio Falconiano para las medidas Sanitaria y Prevenci√≥n al #COVID19. Cu√≠date üò∑. #23Abr #FANB #GNB
#PrevenirParaVivir
#GNByPuebloUnido
.@NicolasMaduro 
.@cmdtegralgnb
.@GNBGDjuvenal
.@LopezvargasR

 https://t.co/Uu73XYdIvr",41357,85077,12699,139133
629,@Banesco Ya solucion√©. Lo que hice fue agregar el n√∫mero de nuevo al directorio. Gracias,82254,29003,28852,140109
630,"En la √∫ltima semana han salido del estado 31.126 personas desde el terminal de pasajeros de San Crist√≥bal por el plan de evacuaci√≥n, esto en 1941 unidades de transporte hacia distintas ciudades del interior del pa√≠s como Caracas, Valencia o Maracay.
https://t.co/hiXHmn9h11",39257,16588,47676,103521
631,"@soyvarenka @EslandesOficial @laidygomezf @FreddyBernal @TarekWiliamSaab @WalterDossier Por una mocho de compota se lo llevaron preso, no se quien es PEOR, el tipo que lo atrapo o los polic√≠as que respondieron a ese llamado. Que pat√©tico sera que en Tachira hay un Escuadro Anti- hurto de Compotas?",2507,88348,86711,177566
632,Que viva la patria y los buenos representantes del legado de Ch√°vez. S√≥lo en revoluci√≥n  venceremos.,33494,36557,22548,92599
633,Daniel_RiosVE: Avi√≥n hace aterrizaje de emergencia en Nueva York tras ‚Äúincidente de seguridad‚Äù con pasajero https://t.co/W09zjpsniY #DanielRiosTeInforma #Valencia #Carabobo #Venezuela,8602,28545,49236,86383
634,Se√±ores @hidrolagoofic @HidrolagoMcbo @HidrolagoZulia2  las comunidades de los Modines el Pedregal Nueva Independencia la Rotaria 4ta etapa de la parroquia Ra√∫l Leoni llevan 14 d√≠as sin llegar agua los que si llegaron fueron los cisternas para joder al pueblo @willy_casanova,56645,76462,64045,197152
635,"@Rduvalls @20Venceremos @2021Luchadora @OMER232311 @20Mivzla @guzzy_9 @Edinsonvh @Shadday10461061 @LoiseVe28 @teffivzla26 @SobrePC @ch_cdg @4Frevolucion2 @Angel30308 @churuguara @SIKIU21 @NORISAQUINO7 @auriany_fuentes @will6942 @mozkovo Mi reciente art√≠culo en  Aporrea: ¬°Se acabaron las mafias en Guayana! Gobernador de Bol√≠var: ""Me mete preso al se√±or por no cargar mascarilla. B√°jese y va preso""

https://t.co/5Ii8rgoa4V",89324,716,63918,153958
636,"Escuela de Teatro Ram√≥n Zapata,ubicada en Valencia frente a la Gobernaci√≥n de Carabobo, requiere urgente ayuda Gubernamental ya que sus espacios internos se encuentra en total abandono apoyemos con un RT la restauraci√≥n total de este Patrimonio cultural. https://t.co/z5Ma0BYrh7",41889,63909,68662,174460
637,"Los seis detenidos en #Carabobo pertenecen a una banda de trata de personas que opera entre Caracas, Mirada y T√°chira https://t.co/ewa15L1mC3",85589,75529,63279,224397
638,"#12deOctubre | As√≠ se desarroll√≥ la #MarchaParaJesus en el estado #Aragua, la cual inici√≥ en la Av. Bol√≠var, frente al diario @elsiglocomve hasta el estadio Tacita de Plata. 

#YoMarchoParaJes√∫s #Maracay #Venezuela #JesucristoEsEsperanza https://t.co/OxN0H84SQl",6066,48134,23518,77718
639,@HIDROFALCON Nosotros tambi√©n en el 23 enero de punto fijo tenemos bastante sacrificio gracias a ustedes 45 d√≠as sin agua bandidos @nicolasmaduro,78807,96701,23950,199458
640,"Reina P√©rez y @Albertlamberto por la unidad democr√°tica casa x casa manzana B12 de la esmeralda mostrando a los vecinos como ejercer su voto, Votando por la tarjeta de la MUD.  @leonjura Alcalde @ENZOSCARANO Gobernador. @partidoUNT @unt_carabobo @angelunalira https://t.co/gnGmLbXXDa",95553,48336,16358,160247
641,"No se ha echo efectivo el bono de los 46,00 @CarnetDLaPatria  @BcodeVenezuela @BonosSocial",27842,65058,55967,148867
642,"@FreddyBernal Logra acuerdo desde San Antonio del T√°chira para la apertura de la frontera y lo sella con un apret√≥n de manos y un buen caf√©.

#FreddyAbreFronteras
üíõüñ§‚ù§Ô∏è

@NicolasMaduro @IvanDuque @delcyrodriguezv @Juntosxtachira1 @arguelloyepfri @Silfredo_Z @dcabellor https://t.co/khQqBq2uJ6",34443,51174,38371,123988
643,"#26Abr | La Pen√≠nsula de Paraguan√° posee dos Monumentos Naturales, que son muestra de la riqueza natural del estado #Falc√≥n: el Cerro Santa Ana con sus 5 pisos bi√≥ticos y la Reserva Biol√≥gica Montecano.

#FelizLunes #FalconLoTieneTodo @willymedina8 @JosueLorca https://t.co/8CJpnsydY9",95006,52915,47833,195754
644,@pizarro354 @Noticia_tachira Este falso personaje llamado Esteban C√°rdenas jamas se va convencer de la burbuja de mentiras .as√≠ caiga un chsvista con los kilos el va a justificarlo el porque tenia esos kilos. Eso delo por hecho que es @pizarro354 gentecita ciega totalmente defendiendo donde no recibe nada,29185,25505,56988,111678
645,"El .@FalconGnbcz mantiene despliegue en el territorio Falconiano, para garantizar la seguridad y la salud del pueblo. #3Abr 
#SputnikVGarantizaVida
#GNBGaranteDePaz 
#FANBEnDefensaDeLaDignidad
.@NicolasMaduro 
.@cmdtegralgnb
.@LopezvargasR
.@GNBGDjuvenal https://t.co/e3SqjTEDQq",68654,9420,29913,107987
646,#Comunidad - Paraguan√° acat√≥ cuarentena radical en Semana Santa https://t.co/LLFctQ8jQ8,54158,70130,37629,161917
647,"Capturan a poderoso narco falconiano, Emilio Mart√≠nez, alias ‚ÄúChiche Smith‚Äù, con v√≠nculos en el alto gobierno de Maduro https://t.co/xvXQfMC5AK",14834,79249,99412,193495
648,Ese es hijo del padre de la medir√° (el Diablo),45194,34328,25137,104659
649,"En Bogot√°
El pedalista,Jos√© Tito Hern√°ndez del Team Medell√≠n, asumi√≥ liderato Vuelta a Colombia, al final octava etapa con 26h 52m 55seg

2 Alexander Gil Orgullo Paisa 0:01
3 Arist√≥bulo Cala Sundark Arawak 1:30
4 Danny Osorio Orgullo Paisa 3:34
5 Juan Pablo Suarez EPM Scott 4:47 https://t.co/2udn9k8NQv",53983,19665,38001,111649
650,Fotos de tercer proyecto de reforestaci√≥n en Cayosal Chichiriviche https://t.co/a41ARuq66P,70961,65700,56491,193152
651,ya punto fijo est√° caliente desde temprano s√°quenme de aqu√≠,3447,1121,64891,69459
652,@TarekWiliamSaab @MinpublicoVE Miserable por una compota est√° no es tachirense esa seguro es colombiana que mala genteeeeee,64135,88870,38107,191112
653,#Sucesos   EN CARABOBO: Asesin√≥ a su madre en medio de una discusi√≥n y tambi√©n lesion√≥ a una beb√© https://t.co/KokiudGw1j,53211,20427,63497,137135
654,"@PriyamvadaGopal I, for one, would have loved the opportunity to visit 5-star hotels in the independent Arawak nations",14548,99685,19248,133481
655,"de Falc√≥n y la pen√≠nsula de Paraguana. Predicci√≥n : El conflicto de Apure se quedar√° as√≠, como un mal entendido d√≥nde los muertos quedar√°n muertos y enterrados en beneficio de los negocios y pronto estaremos viendo a las FARC en la Sierra de Falc√≥n (D√≥nde est√°n las caletas)",25383,40399,63526,129308
656,"#Economia - Piden denunciar a comerciantes que no usen la tasa del BCV

#4Oct  
#BCV 
#Comerciantes 
#PortaldeNoticias 

https://t.co/GZe8veIzOA",34371,1257,33911,69539
657,"#ESPECTACULOS Muere por covid Henry Stephen, el cantante de ¬´Lim√≥n, Limonero¬ª https://t.co/ypSSTlDUqQ",10207,13873,34627,58707
658,"#LoMasVisto | Chiche Smith, apresado por narcotr√°fico, daba regalos, empleos y hac√≠a obras en la comunidad de Carirubana, estado #Falc√≥n. Conoce qui√©n es este sujeto que fue detenido en #Anzo√°tegui  #9abr https://t.co/YdmK0FOygd",67722,31087,89789,188598
659,"Tras ser detenido por la DCGIM el ahora preso pol√≠tico Francisco Pacheco fue llevado su residencia en el estado Carabobo para allanarla, Luego del allanamiento los familiares de Francisco no supieron de su paradero por 21 d√≠as.
#LiberenAPacheco https://t.co/jhPQTvgO4z",9342,53348,92943,155633
660,"Feliz S√°bado #Carabobo. Lev√°ntate, no te rindas, no te desanimes, el ma√±ana mejor estar√° m√°s cerca si trabajamos juntos para lograrlo. https://t.co/rJ7joHVqfL",64317,59490,66894,190701
661,@RamonAcosta1985 @iradialberto Si hay gigantes en curvas del Estado Bol√≠var no hay ni una foto o testimonio real que se pueda creer? Pregunto yo en mi ignorancia,5212,81515,12772,99499
662,#ModoActivo En sinton√≠a de la @LaHojillaenTV por @VTVcanal8 desde Coro Estado Falc√≥n siguiendo la cuenta alterna del camarada diputado @SilvaHojilla #SputnikVGarantizaVida https://t.co/mrL7ytqAZg,66055,31627,92802,190484
663,"Locava se la pasa inaugurando vainas all√° en Carabobo, de verdad est√°n bien hechas o es pura mierda?",38848,16825,55952,111625
664,Presos por desinfectar...Cosas del dictador... https://t.co/xMZIqajHu8,62593,95111,74208,231912
665,"En el @PacMesonesanz de Barcelona, fue capturado ciudadano requerido por el MP de Carabobo por hurto calificado #GNBAnzoategui #15Oct #FANB
@GNB_Anzoategui https://t.co/X3ngQcgCak",72557,6131,42477,121165
666,"‚ÄúVamos bien, aunque no ha sido f√°cil resolver lo que hab√≠a en el pasado‚Äù: candidato Bres Garza
https://t.co/hSWlGTdJTG
#PiedrasNegras #Elecciones https://t.co/gUkMVR1X0W",35087,47097,27192,109376
667,hay que matarlo a toos,15069,89997,90903,195969
668,"En el Complejo Carcelario de Pedregal en Medell√≠n, avanza jornada de inmunizaci√≥n contra #COVID19 para privados de la libertad mayores de 60 a√±os. https://t.co/OqbYx6FYXg",13475,72546,1762,87783
669,"#ColombiaAlAire | Procuradur√≠a pidi√≥ mantener la investidura del senador Gustavo Bol√≠var, en medio de la demanda que estudia el Consejo de Estado para decretar su muerte pol√≠tica.

üìª‚û° https://t.co/LPPvSZPln8 
üì∏: Colprensa. https://t.co/TSWEx5dnX5",5767,44297,47991,98055
670,"Amigos, buenos d√≠as ‚ú® Hoy amanecimos con toda la actitud ü§ó porque a las 7:00pm tengo entrevista en el programa #Yaleva por @TelevisaGolfo üíú‚≠ê

 ¬°No se lo vayan a perder! 
#soyalyna #mexicana #mty #piedrasnegras #puebla #saltillo #tamaulipas #coahuila #cumbia #texmex #texas https://t.co/lq2fb3wugy",52442,53284,60841,166567
671,Feliz domingo mi gente de la pen√≠nsula de Paraguan√° riko y apreciado amanecerüòàüòàüòà,42070,32091,65709,139870
672,jueves #07O se registran mil quinientos decinueve (1519) nuevos casos de #Coronavirus #Covid_19 #Carabobo con (35)‚òπÔ∏èpara un total ya de (379.352) contagiados en #Venezuela se suman (18) decesos‚òπÔ∏èpara un total ya de (4576) @opsoms @WHO @ONU_es @OEA_oficial  #ONG #CruzRoja,74022,93717,14118,181857
673,#TENDENCIAS Perdi√≥ custodia de su hijo por culpa del famoso videojuego 'Fortnite' https://t.co/GY1vHCFVVH,14448,10083,67035,91566
674,"Hacemos alianza con  @ZonaEducTachira y brigadas y de salud para dar atenci√≥n a trabajadores de @CORPOANDES despegados en los municipios haciendo el T√°chira que merecemos
@embacubaven 
@CubaMINREX 
@CubaPlataforma 
@siempreconcuba
@FreddyBernal
@Silfredo_Z
@charlychaves https://t.co/ojRd5tKQYJ",83068,73751,61955,218774
675,"El sistema el√©ctrico de mi zona sali√≥ ileso del fuerte #aguacero,que ya est√° culminando.Hasta ahora sigo con luz,gracias a #Dios.
 
#Valencia #Carabobo https://t.co/Ki8EObH8tt",93843,72330,55818,221991
676,"#7Abr Se agrava situaci√≥n de la gasolina en el estado Falc√≥n #Pais 

https://t.co/h7678khYP8",86981,63312,19469,169762
677,En v√≠spera del 5 Aniversario de la desaparici√≥n f√≠sica de nuestro Comandante Fidel Castro y enmarcados en la Jornada Camilo y Ch√© los j√≥venes del CDI 19 de abril del Estado de Bol√≠var realizan su Activo Juvenil @Cubacooperabol2 @CubaVa_Bolivar2 @cubacooperaven @AnayansyPR https://t.co/S5ZiWNidEn,82993,26607,52493,162093
678,#5Oct Jos√© Guerra afirma que la intervenci√≥n del BCV en el mercado podr√≠a provocar una ‚Äúmega devaluaci√≥n‚Äù https://t.co/Wh7NmCDYgr https://t.co/wzQThE24VL,33244,82821,36878,152943
679,"Whatsapp: 0424-7724969
https://t.co/ascexQRF2N
Sitio Web:
https://t.co/FRc5PMY0nK 
IG y Twitter: @MadisonSC18
#sancrist√≥bal #t√°chira #moto #repuestosvenezuela #madison #cauchosnuevos
https://t.co/vFyq9BzzFC",2405,94658,20190,117253
680,"@JAVIERBERTUCCI EPA BERTU ser√≠a que se te acab√≥ la plata lo dudo recuerda como te sacaron del imperio mismo recuerda que eres el pastor m√°s farsante y corrupto de la historia contempor√°nea del pa√≠s 
Ni a presidente de un consejo comunal el Carabobo llegas no tienes las bolas https://t.co/ggfdZvKQuo",46618,66533,40825,153976
681,Para cu√°ndo los reembolsos ya que el martes me debitaron un dinero que me hab√≠an pagado ese mismo d√≠a y en la noche ya no lo tenia,71049,99832,25622,196503
682,"#14Oct üì∞ | Detenidos seis individuos en Carabobo por trata de personas: 

Fueron interceptados trasladando a menores de edad https://t.co/hTOB8d4bKq",8908,20911,2586,32405
683,"Bomberos de la #CdMx trabajan para sofocar el #incendio de pasto registrado en la colonia Fuentes del Pedregal, en @TlalpanAl. 

#C5 #911CDMX https://t.co/GlrCKzje0P",94239,42596,19424,156259
684,"Desde el pasado domingo se registr√≥ un movimiento inusual en la frontera, con la llegada de representantes del Ministerio de Obras P√∫blicas, que verificaron el estado del puente, as√≠ como de aduaneros, que espera luz verde para iniciar operaciones. https://t.co/mzPjRMElul",32172,38757,65029,135958
685,"Representantes de diferentes organizaciones civiles y ciudadanos caminaron desde Rubio, Municipio Jun√≠n del Estado T√°chira, hasta la Iglesia la Ermita en San Crist√≥bal, en apoyo a los tres de @FundaREDES_ y todos los presos pol√≠ticos del pa√≠s. #Coalici√≥nAnticorrupci√≥n",7101,25678,12988,45767
686,"#30Agosto cada lunes comienza una nueva semana de buen esfuerzo, de trabajo y dedicaci√≥n es un buen tiempo para comenzar tambi√©n nuevos retos y llenar nuestra mente de la manera como Dios desea que vivamos. #FelizInicioDeSemana @laidygomezf @GobiernoTachira @CeciliadeRoche1 https://t.co/Wbzgebn2iY",92849,49675,55593,198117
687,La Direcci√≥n de Protecci√≥n Civil de #PiedrasNegras emite el siguiente Bolet√≠n Meteorol√≥gico. ‚òÅÔ∏è https://t.co/pvuqNnG1dW,58361,38924,27657,124942
688,"@EneidaLayaPsuv @BCV_ORG_VE @ViceVenezuela @MinEcoFinanzas @Mippcivzla @MMoncadaVTV @Yvke_Mundial1 @avnve @laradiodelsur @SomosRMNoticias @TVFANB Siempre desplegado 

#ProducirEsVencer 

@PR360Consultor @ejalvarezg",3876,39880,2726,46482
689,@alfredcandela @JonLord3 @lergpv En San Diego ...Edo Carabobo nos pas√≥ que en los edificios donde viv√≠a lleg√≥ una invasi√≥n de rabipelados...Se met√≠an en los apartamentos..cuartos de basura...en los techos...Pero as√≠ como llegaron se fueron.,20913,57692,8719,87324
690,"@CarmenV33368370 @OMER232311 @2021Luchadora @20Mivzla @guzzy_9 @20Venceremos @Edinsonvh @Shadday10461061 @LoiseVe28 @teffivzla26 @SobrePC @ch_cdg @JVRO1404 @Angel30308 @churuguara @Sikiug2 @maricas24 @auriany_fuentes @JoseePatria @liriomio @hugocary @w_semillita @yop226 @omalopez78 @luchaalmada feliz noche @CarmenV33368370 

#TodosContraElVirus",35981,61975,83761,181717
691,"#Guachim√°nElectoral | Las gobernaciones de Amazonas, Anzo√°tegui, Bol√≠var, Carabobo, Lara, Miranda, Nueva Esparta, Zulia y la alcald√≠a del Distrito Capital podr√≠an ser ganadas por el chavismo o la MUD debido al cerrado margen de las √∫ltimas contiendas https://t.co/kWD5VcM9Ci",43680,88600,80381,212661
692,"@mafasu Pen√≠nsula de Paraguana, playas, m√©danos. https://t.co/xVb8Q5KRQq",99312,55555,88135,243002
693,"#CantvLoHacePosible

En T√°chira, Cantv realiz√≥ tendido y empalme de redes, instalaci√≥n de manga y aseguramiento de la taquilla, para restituir los servicios de telecomunicaciones a los habitantes de los municipios Bol√≠var y Ure√±a, afectados por vandalismo. 
#Ch√°vezPorSiempre https://t.co/dMMhrLnHU8",88696,48772,88791,226259
694,@BcodeVenezuela @rmfinanzas Sres que pasa que los bonos tardan tanto para hacerse efectivos en su banco,61873,48128,52329,162330
695,"La Gobernadora del TACHIRA,se la cant√≥ claro a Freddy Bernal ‚Äú protector‚Äúquien con mentiras quiere ahora ser el gobernador pues muy cierto lo que dice la gobernadora Laidy,si es as√≠,‚Äúretiren container que ellos pusieron‚Äú.Eso es propaganda que nadie cree. #AlTachiraNoLoEnga√±anMas. https://t.co/IheTwqUvE6",9289,52984,39115,101388
696,"Inician obras de¬†Multideportivas¬†

https://t.co/ifOxnIlcqK

 Se benefician familias de las colonias Jes√∫s Carranza y Pedregal¬† CUATRO CI√âNEGAS, COAH. ‚ÄìCon inversi√≥n de casi 2 millones de pesos, contin√∫a la construcci√≥n de canchas multideportivas, en las‚Ä¶",85416,29440,52515,167371
697,@Edurodriguezg Saludos Eduardo como sigues de la Lumbalgia? Saludos desde Coro Edo. Falc√≥n. Fiel seguidor de tu programa A Tiempo por #IVC,32015,38629,63065,133709
698,@MSVEnLinea @ElMonstrico13 @CarnetDLaPatria @MSVEnContacto @NicolasMaduro @MSVCarabobo10 @PresidencialVen @ViceVenezuela @drodriven2 @jaarreaza @JeanMGProject @Mippcivzla @VTVcanal8 Wilfredo garces 7565156 punto fijo,27952,91022,7158,126132
699,@ENZOSCARANO Grandisisisisisimo gran HDPTA cuanto te paga el r√©gimen por ese papel√≥n rata que le importa al resto del pa√≠s Carabobo plasta de mierda el pueblo ya sabe que esas elecciones est√°n arregladas te van a dejar Carabobo y que nos importa eso a los del tachira plasta de mierda,58257,79888,99887,238032
700,"@DolarToday Paraparal los Guayos edo carabobo, edificios los frailejones y urbanizaci√≥n yurubi 4 a√±os sin servicio ABBA ni tono cantv por favor ayudennos el problema est√° aqu√≠ en la central cantv de urb. Tacarigua en paraparal https://t.co/jMW4kmXdkB",14964,85814,62183,162961
701,Kentaro Miura out of his element.. when these chapters of falconia dropped it was clear he was just flexing his muscle on the manga world.. he's letting the world know who's the best. No computers generated drawings.. this is raw pen and pencil. Fucking god like https://t.co/AkaMpfF4RN,50017,8338,82301,140656
702,@RMarcoTorres @BrullerbyPSUV El tiempo pasa y nada que distribuyen gas a ca√±a de az√∫car sector 10. Y eso q prometieron c/15 d√≠as alternando @GasAragua con Estebita gas. Hasta cu√°ndo enga√±an al pueblo. @LimonActivo @churuguara @amiramucic,52522,5083,57713,115318
703,"@rafaellacava10 Pura PAJA este tipo si es covero, puro show... Naganagua sin agua, san diego sin agua, la Isabelica sin agua, sim√≥n bol√≠var 1,2,3 y 4 sin agua, y asi ad infintun en casi el 90% del estado Carabobo. Bajase ese moj√≥n de su bezaca porque viene voto castigo pa los malandros del psuv",50692,63843,35240,149775
704,"Hola @indafrero he dicho que no soy economista...
Hace rato reviso page de @BCV_ORG_VE Y marca 4,16**** el d√≥lar 
Pero lo marca para ma√±ana jueves 07
Por qu√©?

Y por qu√© @#‚Ç¨%%&amp; tiene tantos decimales,si el dolar negro si se ajusta a ser n√∫mero entero #VenezuelaTieneConQue #6Oct https://t.co/6PncnPATno",3713,83569,43042,130324
705,"Acaba de publicar una foto en Coro, Falcon https://t.co/xBMSS7KOAT",81536,79531,11464,172531
706,"CDI panamericano tachira
#MMedicaCubanaTachira 
#Aniversario61FMC 
#ACubaPonleCorazon 
@CdiPanamerican1 https://t.co/jVcnlLEtVC",81313,1875,44248,127436
707,"@ErailanJesus Si, veo la firma del BCV o de alg√∫n organismo Oficial. Con esa foto, puedes decir que el d√≥lar va a bajas a 1,10 y que te los vendan todos a ti.
Sigue enga√±ando...",899,45582,24174,70655
708,Gustavo Bol√≠var mantendr√° su curul en el Senado: Consejo de Estado no le quit√≥ su investidura https://t.co/RAFF3IrDOi v√≠a @burbujapolitica,23048,47023,31969,102040
709,"miro a un punto fijo pa evitar que se me note, nena, que me rompo cuando canto esto",44993,8872,20168,74033
710,@BcodeVenezuela que pas√≥ con la lista de ganadores del 2do sorteo?,91647,81887,60883,234417
711,Capturan en Carabobo a seis miembros de una banda dedicada al tr√°fico de¬†personas https://t.co/PAMU4C8Cph,83045,31467,9942,124454
712,@maperezpirela @teleiguana El $ del BCV M√ÅS CARO QUE EL PARALELO. Quiarrrrrrrechieraaaaaa!!!,68620,49473,7238,125331
713,"#TasaDeCambioüìàüìâ | As√≠ cerraron los indicadores econ√≥micos este viernes 29 de octubre:

BCV: Bs. 4,39 ‚ûñ

PETRO: Bs. 246, 74 ‚ûñ
‚Äå
PARALELO: Bs. 4,47 ‚¨áÔ∏è

#SoyNuevaPrensa https://t.co/QhyB4G5sn4",25074,14797,91981,131852
714,"Centinelas del .@GNB41_CARABOBO, realizar√≥n la aprehensi√≥n de una (01) Cddna solicitada por el delito de estafa, A/O del @MinpublicoVE #GNBCaraboboSeguro
#16Oct #JuntosSomosM√°s
#VenezuelaTieneConQu√©
#GNB2daD411Carabobo
.@PresidencialVen
.@PrensaCmdteGral https://t.co/Am1NPRjv1g",89567,82144,48767,220478
715,@mwords25 Mira aqui en exüáªüá™ en cualquiera de esos publicos con horario estan pidiendo 1$ diario a la taza del bcv,57512,75407,90802,223721
716,A los cuantos d√≠as es que se restablece el servicio? ,78423,73260,73505,225188
717,"Los importadores que en su mayor√≠a son distribuidores en todos los rubros,son vulgares asesinos de la patria y pueblo,no respetan el d√≥lar BCV falsifican las facturas,todo lo que suben m√°s nunca lo bajan ,a ellos mano dura.",53329,46238,83671,183238
718,#INTERNACIONALES Camarera es asesinada a tiros por su exnovio en el restaurante donde trabajaba y frente a los clientes https://t.co/SXeufYcoRh,58325,91434,26535,176294
719,"Hicimos unas visitas de acompa√±amiento a la Asociaci√≥n Damas Salesianas, en #T√°chira, porque fortalecer las relaciones con la Red es un compromiso asumido por #Avessoc. 

https://t.co/VyXxlVdzPE https://t.co/1lvOZDP6AH",97592,46220,11640,155452
720,"#MartesDeAtencion en la @tachira_gmas a los usuarios que acuden para solicitar la revisi√≥n de sus casos, solicitudes y denuncias, hoy #14Sept aproximadamente atendimos 32 personas con un alto porcentaje de casos resueltos 
@FreddyBernal 
¬°Seguimos Venciendo! #YulimarEsVenezuela https://t.co/qUAA5t5gYO",70349,30207,16952,117508
721,@NicolasMaduro La milicia del Estado Falc√≥n activa y presto por nuestra revoluci√≥n Leales siempre traidores nunca independencia o nada,55675,2832,32922,91429
722,"V√≠a @meteovenezuela Tiempo Venezuela 5sep 5pm: Para la hora la convecci√≥n se ha expandido por Zulia E-COL, Falc√≥n-Lara O, Miranda, Gu√°rico NE. Se mantiene en Delta, Bol√≠var O y Amazonas. Aislados n√∫cleos en Sucre O, Apure y T√°chira S. Visible https://t.co/IZqOp0Tsx1",18546,95674,93410,207630
723,"En el estado Carabobo (ARC) en la autopista regional del centro sus estaciones de servicio que abarcan toda la zona en confabulaci√≥n con entes policiales y nacionales se niegan abastecer de gasolina a los usuarios. Alerta @NicolasMaduro, mano de hierro...!",49796,23719,97218,170733
724,"@cmdtegralgnb @gnbfalcon13 @POLIFALCON @vladimirpadrino @PrensaFANB @Mippcivzla @VTVcanal8 @PresidencialVen @dcabellor @jaarreaza @LopezvargasR @snaoficial_ #24Abr #FANB #GNB
#PrevenirEsClave
#GNByPuebloProtegido
.@NicolasMaduro 
.@cmdtegralgnb
.@GNBGDjuvenal
.@LopezvargasR
.@Redi_Capital2
.@zodicap41
.@JackieCPSUV
.@GNB_Capital
.@GNBGaesCapital
.@Cmdtgaescapital
.@2docmdtegaescap",25101,92267,64628,181996
725,"Sindicalista Horacio Silva: refiner√≠a El Palito sigue paralizada y no se avizora arranque (V√≠a @ElPitazoTV)

https://t.co/0ZVvG34IL4",12781,74197,96466,183444
726,@GobiernoTachira QEPD,80015,32041,68347,180403
727,@kerwinpilon @Banesco @Baneskin Conmigo ni se comunicaron @SudebanInforma ay√∫denme amigos de sudeban.,27172,86757,90944,204873
728,Abren canal humanitario temporal entre C√∫cuta y T√°chira https://t.co/C3wkpF7q9J,36501,3388,52973,92862
729,"üì¢ La .@GNB_Lara mantiene campa√±a de prevenci√≥n para evitar la propagaci√≥n del COVID 19 en el territorio larense.  #8Abr #FANB #GNB
#JuntosContraLaCOVID19
#GNBEsPueblo
#PuebloYFANBPorLaPatria
.@NicolasMaduro 
.@cmdtegralgnb
.@GNBGDjuvenal
.@LopezvargasR
 #GNBFalc√≥n https://t.co/NudaIp09OO",68762,13005,41897,123664
730,"Una mujer habl√≥ en exclusiva para¬†El Pitazo¬†y dijo que una de las cabezas en la plaza El Jobo de El Callao, estado Bol√≠var, es la de su hija, testimonio que da luces sobre el caso. A continuaci√≥n les mostramos algunas claves de lo que se sabe hasta ahora https://t.co/MLfDIIKzAC",16820,787,50602,68209
731,#SUCESOS Joven estuvo a punto de morir por sobredosis en T√°chira: Se rompieron los dediles que ingiri√≥ https://t.co/DdVuzwK7fx,45354,99907,62398,207659
732,"Programa radial Punto de Arranque... Para un buen comienzo... en Pregonero, Tachira, Venezuela https://t.co/3HA3i0pGkv",81646,57572,14512,153730
733,M√°s de 100 muertes violentas de adultos mayores en Venezuela https://t.co/qSvTi99956 #noticias #carabobo #venezuela https://t.co/KjQZ5xN24Z,63336,29222,978,93536
734,"M√≠ Maravilloso Recuerdo üòç
Desde Coro Edo Falc√≥n
Esa sonrisa...
M√≠ fot√≥grafo, siempre JG tambi√©n m√≠ seguridad personal üòÇüòÇüòÇ definitivamente m√≠ todo, m√≠ regalo de Dios. https://t.co/r4jcFEPs7s",9699,35867,73898,119464
735,Odio mucho cuando voy pillado de tiempo y pasa algo que me retrasa. Ahora por ejemplo estaba a punto de salir de casa y llaman al fijo del instituto de mi hermano üôÑüôÑ,35145,41096,94528,170769
736,Novedades en nuestra ciudad. Espectacular Nera del chef Marco Carboni en Jardines del Pedregal en el sur de la #CDMX https://t.co/rgtiI8uAKU,52396,2163,49956,104515
737,"@sebasdrop honestamente, yo me siento indiferente por la victoria de big e, no me alegra pero tampoco le voy a tirar mierda",31376,13210,88760,133346
738,Secuestraban a menores en Caracas y Carabobo para luego prostituirlos en¬†Colombia https://t.co/puIwHglfH9,94504,22859,10359,127722
739,"Por favor alguna autoridad que se preocupe por la U.E.N ""Madre Teresa de Calcuta "" Yagua  Municipio  Guacara del Edo. Carabobo. Las condiciones de estas instalaciones se encuentran en p√©simo estado. Urgente Ministerio de Educaci√≥n S.O.S https://t.co/xaTeBSXXxc",78646,6896,14146,99688
740,"El Frente de Profesionales y T√©cnicos del Estado Bol√≠var, se reuni√≥ en la sede del Psuv Ciudad Bol√≠var a fin de ratificar el apoyo a l@s candidat@s del PSUV- GPPSB en el Edo Bol√≠var
#VictoriaPerfecta21N
#Bol√≠varRenace
#JuntosHacemosMas
#MarcanoGobernador
#SergioAlcaldeReelecto https://t.co/DJi3mMqdyi",28656,29067,433,58156
741,#15Oct  ¬°Aqu√≠ Nadie se Rinde!  üí™üèΩüí™üèΩü¶áü¶áüáªüá™üáªüá™ #VacunarseDependeDeTi #carabobo #lacava #docentes #viernes https://t.co/91jAVbwvva,52813,93014,42006,187833
742,"@rafaellacava10 Carabobo sin agua, sin electricidad, sin gasolina pero las calles full de basura y de huecos",15556,35551,55859,106966
743,"üõëLa .@GNBunidad_vial se mantiene Activa en el Km-131 de la #ARC estado #Carabobo, Garantizando Seguridad y Auxilio Vial a los usuarios de tan importante arteria vial.

#2Oct #G.N.B #FANB
@GNBCmdtGral
@vladimirpadrino
.@Viloriarca1 
#Vac√∫nateContraLaCovid19 https://t.co/RzlvxQZx3r",65956,69106,5038,140100
744,"Buenos das, queridos amigos en este domingo de poco sol en esta comunidad de Naguanagua, Estado Carabobo. Ojala el gobernador se acuerde de este pueblo y haga operativos de mercado para los mas humildes.",26446,79177,81291,186914
745,dej√© a mi sobrino en el colegio y mientras esper√°bamos las de tercero y cuarto pensaron que las estaba mirando mal flaca estoy mirando un punto fijo en la nada mientras tarareo temas de morning musume ni s√© qui√©n sos,22894,38549,17311,78754
746,@CancilleriaVE Lo peor es que la mayor√≠a andan asi si revisaran se dar√≠an cuenta el derroche que hay en coro falc√≥n üò≠üíî,99893,87153,59407,246453
747,"#CentinelasGarantesDePaz|| Desde el estado Barinas nos preparamos para contin√∫ar nuestra gran labor al servicio de la Naci√≥n.

#25Sep #CEOFANB #GNBBol√≠var 
#LasSancionesSonUnCrimen
.@PresidencialVen
.@PrensaCmdteGral
.@Barinascz33 https://t.co/lMBr0BquBk",90915,29897,40863,161675
748,"Nunca me cansar√© de hacer el bien! -Jehov√° es mi pastor, nada me faltar√°!

¬øCu√°ntos dicen am√©n?

De d√≥nde me lees, comenta y s√≠gueme y te sigo! ü§óüáªüá™

#12Octubre #Valencia 
#Carabobo #Venezuela https://t.co/vmc9JN2bVO",27958,69544,57310,154812
749,Chicos hoy no va a ver video. La universidad me est√° matando y si quiero tener tiempo para subir el video del √∫ltimo cap√≠tulo de Falc√≥n y el Soldado del Invierno tengo que avanzar.  El team de Yveltal ya est√° en mi Swich. Apenas se pueda lo subir√©. https://t.co/l3mi6CeVyN,67434,61900,88277,217611
750,@CorpoelecCarabo @rafaellacava10 @noticierovv apagon en Naguanagua Edo Carabobo.  Llevamos 2 horas y media sin energia electrica. Recuerden que hay pacientes con covid en los hogares.  Todos los dias en horas de la tarde quitan el servicio SOS.,44724,39572,63964,148260
751,"Estoy muy feliz, porque esta serie es maravillosa, no te deja indiferente y cada cap√≠tulo es mejor que el anterior. Pena me dan aquellos que no saben valorarla, pero mejor, porque los que la sabemos valorar estamos disfrutando de este viaje incre√≠ble ‚ú®üíï

#r√ºyagibi #AdaMasalƒ±",3832,6856,43750,54438
752,"Buenas tardes saludos desde punto fijo @CarlosValmore @chersiaf  suerte a odor en los Yankees porque Texas se canso d esperar por el a pesar de que le deb√≠an dinero, no es f√°cil destacar en los Yankees y menos como suplente el √∫nico que tuvo √©xito en ese rol fue Luis sojo #IVCMLB",38127,70830,85552,194509
753,@Banesco @javiergon56 @CFigueroaRuiz27 Buenas noches. Me bloquearon la cuenta nuevamente sin yo ingresar. Tengo 1 a√±o tratando de sacar una tarjeta nueva y nada ahora como hago para acceder a mi usuario? Por favor ay√∫denme .,54851,1315,22726,78892
754,"La #GNBFalc√≥n realizaron pr√°ctica de Orden P√∫blico, con el fin de fortalecer las habilidades en el mantenimiento del orden interno. #14Abr #FANB #GNB
#Nicol√°sMaduroEsPueblo
#GNByPuebloLeal
.@NicolasMaduro 
.@cmdtegralgnb
.@GNBGDjuvenal
.@LopezvargasR https://t.co/tGVz2eKsRM",95348,6666,79604,181618
755,"¬øDe d√≥nde se origin√≥ la lava que form√≥ el Pedregal de San √Ångel? ¬øC√≥mo afect√≥ la erupci√≥n del volc√°n Xitle a los cuicuilcas? ¬øCu√°nto dur√≥ este fen√≥meno?üëâüèº https://t.co/0CIpzWJ0vy

#5porCINCO con Valeria y Juli√°nüåã
üì∫ Domingo 11 de abril, 19:00 h. https://t.co/XPHC4agvN6",99810,41433,38370,179613
756,"@Soy_Paraguanera Casi un a√±o , si eso no se llama Secuestro, c√≥mo se llama entonces?",10687,23769,84673,119129
757,"@MarcanoemiliaQ Tu eres una l√≠der opositora al igual que Alba Roversi y el Sr de este video. Aqu√≠ los malos son LAS FANB Y SUS L√çDERES NARCOTERRORISTAS. Ellos manejan todo en Venezuela. No hay nadie m√°s, en el BCV, PDVSA, empresas expropiadas, Gasolineras, Alcabalas. Todo
,todo lo manejan ellos. https://t.co/4qjEHoB6QJ",15952,54934,81283,152169
758,"@Banesco desde ayer no he podido acceder a #BanescoOnLine ni desde la app ni desde la pagina web. ¬øQue esta ocurriendo?

#BanescoContigo",27276,62286,73166,162728
759,@BcodeVenezuela Seg√∫n el @BcodeVenezuela realice un pago clave... Cuando realmente no he realizado absolutamente nada... Hasta cuando este problema? y me entero porque me llego un correo ???,90072,94879,81653,266604
760,"Carabobo San Diego Lomas de la Esmeralda.  
Los habitantes de San Diego estamos convocando a todos los que utilizamos el cerro llamado la Rampa subiendo del Parque Skate Park a una jornada de limpieza trae tu bolsa y pala, este S√°bado 9 de Octubre desde las 7 y 30 am. @ONU_es https://t.co/ZQqvb6g0fP",79633,16064,88157,183854
761,"@AlbertoRodNews Sera con dinero del narcotr√°fico o el oro rojo del estado Bolivar. No hay gasolina, no hay agua, falla el√©ctrica, hospital no sirven y las escuelas en el piso, Y este gordo teton construyendo estadio parece inbecil",96190,92226,20422,208838
762,"#Carabobo Obstruidos colectores de aguas servidas en la Urb. Monteserino | #22Oct 

https://t.co/RhQnzBZMEd",65098,15153,42930,123181
763,Regresaron las largas colas por combustible en T√°chira tras elecciones primarias del Psuv https://t.co/b2KozqooMJ,25779,348,30707,56834
764,"#Ent√©rate | Hasta la fecha en todo el pa√≠s se sobrepas√≥ las 12 toneladas y media de drogas (12.592,292 Kg) incautadas en este a√±o en curso mientras que en el estado Falc√≥n, se realizaron 28 procedimientos con 40 detenidos vinculados a estos delitos. https://t.co/o0kM9cD19B",42755,10868,27132,80755
765,"La Delegaci√≥n Estadal Lara se une al duelo que aflige al Gobernador del estado Lara Adolfo Pereira y a su familia por el sensible fallecimiento de su Sra. Madre Wenceslaa del Carmen Antique Falc√≥n. 

Nuestras m√°s sentidas palabras de condolencias https://t.co/cDYe1MTj4P",31243,98627,38128,167998
766,"laidys gomez Gobernadora del Tachira, dice que ha gobernado con las u√±as.

Pero en 5 a√±os en el poder se ha hecho varias cirug√≠as est√©tica y viste como de cat√°logo.

Una m√°s que su discurso no cuadra con sus acciones.",8240,49639,35253,93132
767,@DayanRH_ @MemeluGV @gabo1299 @horta_roxy @mary_980608 @asieldiaz30 @cami__alonso @its_pipo05 @cruz_pigeon @nelsonn_almeida @mona_escritoss @ely_potter_ siiü§£ yo era punto fijo no me lo perd√≠a nunca fui como 2 a√±os seguidos todos los s√°bados !! pero tambi√©n iba x la noche aveces que me dejaban entrar,36733,51151,80835,168719
768,miren si no se une un joe FALCONIANO tiro co√±etazos trif√°sicos,29435,62412,18299,110146
769,"@core_donita @shewritesxdraws @tangerine282003 @VP @maziehirono Ee Lee
Yik Oi Huang
Ming Qu
Ying Wu
Vicar Ratanapakdee
Li QianYang
Rui Zhou
Terence Wallace
InCha Choe
Kelvin Chew
Sun Yi Kwon
Minh Nguyen
Khiem Ba
Xindong Hao
Juan Falcon
Huang Chen
Soon Ja Nam
Sarmistha Sen
Ruth George
Haruka Weiser
In-Ho Oh
Sia Marie Xiong
Sukkee Hong",69454,6113,70557,146124
770,@NellyverLugo @FreddyBernal @Juntosxtachira1 @Redi_andes @ZODI_TACHIRA @TareckPSUV Esta gente que dirige la econom√≠a la producci√≥n el sector social y econ√≥mico de verdad dan pena ajena no se que tienen en la cabeza es que ellos acaso tienen todas las comodidades,49135,66712,55209,171056
771,".@FreddyBernal: Logra acuerdo desde San Antonio del T√°chira para la apertura de la frontera y lo sella con un apret√≥n de manos y un buen caf√©
#FreddyAbreFronteras
üíõüñ§‚ù§Ô∏è

@NicolasMaduro @IvanDuque @delcyrodriguezv @Juntosxtachira1 @arguelloyepfri @Silfredo_Z @dcabellor https://t.co/I2AhJCeURn",54890,60929,90549,206368
772,@rmfinanzas @Mippcivzla @BcodeVenezuela Y la internet se fue,61478,80691,45172,187341
773,M√°s y m√°s canchas en el estado ya est√°n a disposici√≥n de nuestros deportistas y sobre todo de nuestra juventud. Aqu√≠ nadie se rinde. Q viva Carabobo ü¶áü¶áü¶á https://t.co/BiTm5bAl1V,3662,69973,98519,172154
774,@rrrhaaay @premionobel Tienes que llamar a la Rana Ren√© de Udefa para que te refresque An√°lisis y Control de Costos baby jahajaja,48811,43962,30474,123247
775,@mrodoficial As√≠ es Manuel todas las operaciones deber√≠an de realizarse a $ BCV pero siempre buscan una forma de especular,94917,19039,97259,211215
776,".üëë
#LOTTOREY
11/10/2021
3:30 pm
Sorteo#: 3588
27 Perro 

Quieres plata?JuegaLottoRey
juegal #Legal
#RT #RT  
#11Octubre
#Carabobo 
#Zulia 
#Caracas 
#margarita 
#anzoategui 
#porlamar
#bolivar
#aragua 
#oriente 
#maturin 
#cantaura
#Falcon 
#Ecuado https://t.co/Ok7cHVrQvK",53695,91329,98506,243530
777,@elgochoceballos Se llama propagandaüëÄ,42986,90917,36667,170570
778,https://t.co/EyHcAw6AiY  sigue el link pa' que veas el d√≠a a d√≠a en Caracas y toda Venezuela. Esto es Los PoliBrujas! Suscribe #Venezuela #Caracas #crisis  #PNB #GNB #FANB #CICPC #26Ago #Cota905 #LaVega #ElValle #Ocumare #VallesDelTuy #PlazaVenezuela T√°chira Maracay Bello Monte,41162,9368,947,51477
779,Y en diciembre eztamos nuevamente por los millones que cagada de  Gobierno hasta cuando hacen da√±o al pais ,46957,21898,95150,164005
780,#RondaDeSucesos #1abr | Cicpc mata a dos integrantes de la banda del ‚ÄúCoqui‚Äù en Falc√≥n https://t.co/iypSZskR8r,60845,31144,96123,188112
781,Maduro proh√≠be cerrar centros m√©dicos del pa√≠s en pandemia https://t.co/XmnoWvkoWp  #NACIONALES,31145,31828,39318,102291
782,Con tuitazo bioanalistas denunciar√°n ruina de  los laboratorios de los hospitales  p√∫blicos #LaboratoriosEnElPiso  https://t.co/jTpJnVILXa v√≠a @Carabobo es Noticia,38214,47242,1995,87451
783,"@ElNacionalWeb Kit Nintendo Dsi por 2$, incluye: 01 Lector de Tarjeta MicroSD, 03 Protector de Pantalla y 03 L√°pices punta de goma. #Nintendo #DSI #Game #Vende #VenVariedades #Carabobo #Valencia #SanDiego #mercadolibre https://t.co/HtqYnDXGZ1 https://t.co/oCv874lIe7",90340,77617,93871,261828
784,"Gobernaci√≥n del estado Bol√≠var || Secretar√≠a Cultural invita a celebrar en la ciudad de Upata los 46 a√±os del Complejo Cultural Manuel Carlos Piar, con actividades culturales y recreativas bajo las medidad de bioseguridad. https://t.co/gJIN6PQtfq",76813,67473,17908,162194
785,Punto Fijo is Down ?,76453,3397,29444,109294
786,@DanteCo94150246 @Rafaels201 Asi es .. yo era medica en el Angeles del pedregal y la consulta eran 850 mas Iva si necesitaban factura .. Y como cirujana eran otro precio .. yo ganaba muy bien ü§£,95454,41997,827,138278
787,"Los Clap no se detiene en T√°chira
con @FreddyBernal venceremos.
#ClapTachiraSoberaniaAlimentaria

@Juntosxtachira1 @BermudezJoseA 
@PSUVTachira https://t.co/nxCPsVy2uF",30596,62130,33261,125987
788,"Al menos 49 escuelas del municipio Sucre, estado Bol√≠var no tienen ni hojas blancas para retomar las clases presenciales https://t.co/bM3Gi1Vrwf     ~",61919,14427,67528,143874
789,@Jrha8689 Yo tambi√©n vengo de la Universidad de Carabobo cuando exist√≠an estudiantes arrechos cu√°ntas camionetas quemaron por el pasaje y cu√°ntas protestas se libraron all√≠ yo las viv√≠ ...pero no la gente se volvi√≥ amor y paz y le montaron la pata,1969,8814,87920,98703
790,"#Animalitos para #AnimalitosZulianos @losanimalitosz1  

Animalitos que estan Por salir, Cual le Gusta Usted de estos 3 .

Cortesia de LA LUPA DEL DINERO COIGO 8866

#Aragua #Falcon #Caracas #Miranda #VENEZUELA #Margarita  #Monagas #Valencia #Zulia #Carabobo #Ecuador #Colombia",80976,35586,28270,144832
791,"Hola, yo siempre les he hablado de mi hermanita y su diabetes tipo 1 (diagnosticada a los 3 a√±itos) hoy mi mam√° public√≥ que se necesitaban cintas para medidor de glucosa en sangre en Punto Fijo, Estado Falc√≥n, Venezuela, sin decirme nada a mi para no preocuparme, pero igual lo vi https://t.co/nBJT1X8FSC",42397,36570,43182,122149
792,"Plan Carabobo 200 impulsa y dignifica el Centro Hist√≥rico de Coro en Falc√≥n  

#Prevenci√≥nEnFamilia",13510,56544,5546,75600
793,@ManoloDavilatv Difiero ac√° ... Si Tachira fuera primero y sea segura la clasificaci√≥n estar√≠a de acuerdo ... Pero ahora no estamos jugando al menos el 2do lugar para entrar ...,25643,8157,98465,132265
794,#T√°chira volvi√≥ la matraca en puente Real. De la polic√≠a del estado. Ni para eso sirve la gobernadora @TachiraNews @TochadasVE que la gobernadora haga uso de su autoridad y retire las alcabalas. Es un reto ya q quiere ganar otra vez.,58822,62509,17800,139131
795,"Epa D√≥lar Today mira quien viene por Ti. 

1-2 Freddy viene por ti
3-4 cierra la puerta
5-6 coje un crucifijo
7-8 mantente despierto
9-10 nunca mas dormir√°s
#VenezuelaInvencible   
Cr√©anlo.
@BCV_ORG_VE @NicolasMaduro @dcabellor 5",17384,7469,68005,92858
796,Si me ves distra√≠da mirando un punto fijo o estoy cansada o seguramente estoy teniendo una sesi√≥n de terapia conmigo misma en mi cabeza.,12345,4377,7310,24032
797,"En las √∫ltimas 24 horas las autoridades registraron 1.088 nuevos contagios, de los cuales 1.083 se dieron por contacto local y los cinco restantes son de personas procedentes de Panam√°, Brasil y Colombia.
‚úîÔ∏è @diariopanorama",20854,36645,69630,127129
798,MUNICIPIO LIBERTADOR EN LAS MANZANAS CAMPO CARABOBO EL VIRUS ESTA FUERTEMENTE ACTIVO MATANDO PERSONAS DE CUALQUIER EDAD. HAY QUE CUIDARSE EL TRATAMIENTO ES CARO Y EN LOS HOSPITALES NO HAY INSUMOS NI PERSONAL MEDICO Y MIRAFLORES  YA COMENZO LA NAVIDAD Q BOLAS,45217,46289,15636,107142
799,"#5Oct | Denuncian fallas en la distribuci√≥n del gas domestico desde hace 3 meses en la urbanizaci√≥n La Pocaterra.

Ram√≥n Blasco, habitante de la zona, afirma que, pese haber pagado por el servicio, hasta los momentos no han tenido noticias sobre la situaci√≥n del gas. #Carabobo https://t.co/C8kSq8CbgL",93788,99908,1153,194849
800,"La @GNB_CZBolivar contin√∫a en m√°ximo despliegue con el Plan de Seguridad y Protecci√≥n de las Centrales Hidroel√©ctricas en el estado Bol√≠var.

#22Oct #Vac√∫nateEvitaElContagio
PuebloUnidoyCEOFANBVencedor #CZBol√≠var
#PacPalua
.@PresidencialVen 
https://t.co/ARXvItzexf",10732,93074,47783,151589
801,"üî∫BCV ..-&gt; La Liquidez Monetaria SUBE +2,52 % la semana del 15/10/2021 y se ubica en Bs. 2.810.035 .. 
En lo que va del a√±o 2021 la liquidez monetaria ha aumentado 380,4 % ..",33379,19435,27696,80510
802,@monitoreamos En los ivss del pa√≠s sobretodo en Carabobo muchos con covid y obligan a sus trabajadores a trabajar pero NO LE ENTREGAN TAPA BOCAS... D√≥nde como est√° el material de seguridad para sector salud.,96709,38147,24000,158856
803,"Desde Coro Estado Falc√≥n apoyando las etiquetas üîñüîñ  #GuerrillaDigitalConMaduro 
üîñ
#PrevenirEsClave
Y tambi√©n #LaPazEsElCaminoDaniel2021
Si te unes sumamos voluntades en apoyo a nuestro presidente @NicolasMaduro 
üîÅ Por eso apoyo y recomiendo seguir a @elizabe19563832",22078,44395,87236,153709
804,"Municipios del estado T√°chira en el cierre de  Agosto escuelas abiertas 03/09/2021@MPPEDUCACION 
@ZonaEducTachira 
@NicolasMaduro
@yelitzePSUV_
@charlychaves
@COMUNIDADESED15
@edward_arellano
@SPETachira 
@FreddyBernal
@DGEFDMPPE @Arnaldo34696122 https://t.co/c0V6z7qtq2",8180,98748,91662,198590
805,"@BuduOriginal No es secreto que el 95% del cicpc es extorsionador, montan expedientes, roban, etc‚Ä¶ ve parque Carabobo afuera pura Toyota estacionada‚Ä¶ todos son unas ratas, todos",49166,67341,24917,141424
806,"""Si tus sue√±os son grandes, tu capacidad de lograrlos tambi√©n lo es. Solo depende de ti hacerlos realidad. No dejes que nadie te diga que no puedes."", #Venezuela #Carabobo #Naguanagua #SanDiego #Valencia #19octubre https://t.co/JIPxlZRQPV",89317,44143,31845,165305
807,"#Futsal | Academia Campeones Mundiales del 97, oriundo de Col√≥n, Edo. T√°chira ser√° uno de los 8 debutantes del torneo y uno de los dos representantes del estado andino. Particip√≥ en al Liga Nacional 2021. @acampeones97 https://t.co/EZmAgKc6LF",12384,80818,97913,191115
808,"@tonypestana Los peligros de la gasolina y el gasoil artesanal que producen en Falc√≥n
 https://t.co/htAb1unuY8",71456,44550,78390,194396
809,"Sacamos COPIA CERTIFICADA + LEGALIZADA de Actas de Matrimonio,Nacimientos o Defunciones de los Estados:
Miranda
La Guaira 
Distrito Capital ‚úÖ
Aragua
Carabobo
Nva Esparta
Barinas
Falcon
Lara
Portuguesa
Zulia
Merida
Tachira 
Para Mayor Info x DM!!üì≠üì©
#apostilla 
#Saime",17517,98706,11172,127395
810,Buenas noches se√±or freddy espero leas este mensaje .....soy madre soltera de 5 menores de edad estoy viviendo en el gimnacio cubierto de rubio desde hace casi 2 a√±os en la espera de la ayuda de una casita y nadie me toma en cuenta u eso q el q me meti√≥ aqu√≠ fue el se√±or alcalde y lo √∫nico q resibo son atropellos espero usted si me pueda ayudar lo mas pronto posible ....,43177,79508,10272,132957
811,"2021-03-27 25mm en Azul, Buenos Aires, Argentina #pluviomano #gestionagro https://t.co/Aoor0wurKN @caburearg https://t.co/RgDhibhjwq",3441,29994,24087,57522
812,"@rafaellacava10 Todo mal, muy mal en esas fotos, siendo Carabobo uno de los estados con m√°s casos de Covid19.
Dios protege pero hay que ayudarse.",8158,77301,2144,87603
813,"@yosoylecheria Base Cooler para Mini Laptop de Aluminio con 2 Fan con Cable USB M/M para la conexi√≥n, 6$. Hacemos env√≠os nacionales #Cooler #Laptop #USB #Vende #TecnoAccesorio #Carabobo #Valencia #SanDiego #mercadolibre https://t.co/0yV832TgIE https://t.co/OKAT0wXwHX",76565,46185,78142,200892
814,"Cuantiosos da√±os deja choque en la San Joaqu√≠n; responsable huy√≥ del lugar
https://t.co/NHldR1OWd5
#PiedrasNegras #Choque https://t.co/6qvK6tRHq5",88740,76280,58465,223485
815,"Vacunaci√≥n masiva sin cita para mayores de 60 a√±os
#31Ago #tachira #Vacunaci√≥n #masiva #sincita #mayores #60a√±os https://t.co/J7zW2uOBeV",46662,65081,87714,199457
816,"#Falc√≥n | Alrededor de 20 samanes fueron talados en el Paseo Manaure, en #Coro, por el gobierno regional, lo que origin√≥ una ola de cr√≠ticas y protestas. En el siguiente enlace encontrar√° m√°s detalles https://t.co/KzjAkaw3eJ",69939,91745,85797,247481
817,"#3Sep | #LoM√°sVisto | Incesto, amenazas y asesinato: Crimen de padre a hija que conmocion√≥ a T√°chira https://t.co/UjmQK8tTi9",91311,29670,83504,204485
818,"#24octubre | Gran Rafael Jos√© Urdaneta Far√≠as, naci√≥ el 24 de Octubre de 1788, en Maracaibo, estado Zulia. Fue un militar y pol√≠tico, curso estudios al ej√©rcito del Libertador de la Patria, Sim√≥n Bol√≠var y tuvo significado en la Campa√±a Admirable.
@cgrvenezuela  #SNCF #CEZULIA https://t.co/BkeQYzBBJB",84099,63519,37338,184956
819,"Compatriotas d @Hidrocentro2011
Hoy es el 8vo d√≠a consecutivo sin una gota d agua
Carabobo
Mun.Valencia
Pq.San Jos√©
Urb.Prebo3
Av.119 (4 Avdas) #137-71
SectorCasupo
Sin informaci√≥n ni en prensa ni en Twitter
La falta d informaci√≥n produce malas ideas
V√≠ctor Nimo
0241-8245148",91653,98221,8672,198546
820,BCV realiz√≥ una nueva intervenci√≥n cambiaria este #11Oct üíµ | #Econom√≠a https://t.co/VVAX0pe2R0,526,76285,9472,86283
821,¬°TERRIBLE! Dos adolescentes resultaron heridos mientras jugaban b√©isbol en Carabobo: fueron impactados por un rayo #18Oct #Venezuela  https://t.co/KP1xwBsxwz,12995,62471,27473,102939
822,Que tal mi gente en adicora ??,36458,17830,51593,105881
823,Desde la cuna de la robolucion sabateta de Barinas el futuro gobernador del estado Barinas rosales pe√±a https://t.co/cklWKKSAD4,84079,36810,19468,140357
824,@BcodeVenezuela Me paso por segunda vez hoy que hago un pago movil a mi otra cuenta del Bancaribe y el banco me retiene el dinero. Que pasa? Una respuesta por favor,43436,92193,31780,167409
825,@churuguara @InterCliente La semana pasada vino una cuadrilla a revisar y la falla sigue igual en el centro de Barquisimeto.,81518,49861,92409,223788
826,"Este #9Sep a trav√©s de las pantallas de #PDCTVüì∫, nuestro Dir. Nicmer Evans entrevistar√° en #21N a Daniel Ceballos precandidato a la Gobernaci√≥n del estado T√°chira. 

¬°Con√©ctate a #PDCTVüì∫ y no te lo pierdas! https://t.co/TgxAEclEvy",99425,74869,19601,193895
827,"@melnickjeffrey1 @bordergroves And his song ""Christopher Columbus"" is also amazing. ""What about the Arawak indians?""",68325,69912,54622,192859
828,Yo solo espero que el pueblo de Bol√≠var vote con conciencia el 21 de noviembre. Analicen solamente lo que este inepto hizo con las empresas b√°sicas e imaginen a nuestro maltrecho Estado en sus manos. ¬°Dios nos libre! https://t.co/MqCtoWviMG,81506,60438,69483,211427
829,Tienen m√°s de tres d√≠as que no se puede hacer transferencias ni transacciones que sucede realmente.,6442,90186,91979,188607
830,"Hoy, ese chico, me ha dejado impactada... O quiz√° estaba muy drogado y yo era su punto fijo para no morir.",68052,51198,41884,161134
831,"@JuanMontielR @elgochoceballos No, de momento a√∫n est√° resolviendo el tema con su inscripci√≥n, de momento el CNE no le permite escribirse, porque el PSUV y gente que apoya a Leidy G√≥mez (los alacranes) no quieren que participen, porque saben que no hay forma humana que pueda perder esa elecci√≥n en T√°chira. https://t.co/l6JmGuvsip",81660,90290,53762,225712
832,@Rachell20 @J1chiCrow Jajajaja y que es Rana de Oro? Eso no es una barriada en Pedregal o ma√±anitas?,99053,93428,77393,269874
833,@MolangMoon es el chavismo q hacke√≥ las redes como venganza por lo del banco de Venezuela,74707,26833,62649,164189
834,"Encuentro con productores del Sector la Caravela municipio Bolivar estado Barinas, seguimos el trabajo con la Raas y las Ubch rumbo a la victoria del 21N.. https://t.co/2lyGFrt5yU",7469,46816,7145,61430
835,Alcald√≠a de Carirubana eval√∫a aplicar beneficios tributarios a hoteles y posadas https://t.co/6QtSWbkdu5,72640,42869,60869,176378
836,Townhouse en Venta en Puerta Maraven.  Punto Fijo en Punto Fijo/Falc√≥n/Venezuela en Venta https://t.co/47W0kDaDIV,82236,41457,74154,197847
837,@FTB_falconia „ÅÇ„ÅÑ„Çà„Éº,78075,55728,81152,214955
838,"#EsNoticia || #GNB detuvo a un ciudadano con un facs√≠mil en el estado Bol√≠var.

Informaci√≥n üóûÔ∏è ‚û°Ô∏èhttps://t.co/YgbLB2IBEh

#15Oct PuebloYCEOFANBPorVzla
#PuebloVencedor #GNBBol√≠var
#GNBPacPalua
.@libertad003
.@GNBCmdtGral
https://t.co/yWXIuUx0Cq",57124,64126,18487,139737
839,"@FelicianoValen Lo que neg√≥ el Consejo de Estado fue que Bolivar hubiera contribuido a un GRUPO POL√çTICO, esa era la demanda. Ahora, si la primera l√≠nea NO es un grupo pol√≠tico, que es? 
Ser√° que es un grupo delincuencial y eso agrava la situaci√≥n de Bolivar?",76851,67526,28741,173118
840,Me compr√© una esencia que se llama cay√≥ sombrero y SI SABE ‚≠ê‚≠ê‚≠ê‚≠ê‚≠ê,80445,52828,74101,207374
841,"‚ù§Ô∏èüá®üá∫ CDI Libertad Estado Tachira#H√©roesDeLaSalud 
#ACubaPonleCoraz√≥n #CubaPorLaVida @cubacooperaven @MINSAPCuba 
@japortalmiranda @PardoRegla https://t.co/eXQM6F7rBq",52678,94646,22889,170213
842,Franelena Castillo es una cosa incre√≠ble a√∫n no aparece nada en mi cuenta,45012,41791,66821,153624
843,@jesuslopez23 @trotamundosbbc1 @supersmiranda @MeridianoTV Saludos cordiales en total sintonia desde la ciudad de Coro estado Falc√≥n #SLBxMTV @JJuniorCordero @guillearcay @MeridianoTV @germainjaspe üáªüá™üì∫üî•ü§óüëèüéßüéôÔ∏èüõ∞Ô∏èüì°üèÄüôåüí™,83336,44855,68460,196651
844,"@ognimdo @josetin60405649 @lorebornacelly Seg√∫n me inform√≥ migraci√≥n Colombia el paso por T√°chira est√° cerrado, por lo tanto no est√°n sellando pasaporte, a qui√©n creerle...???",17941,23633,65676,107250
845,Nuestro glorioso Ej√©rcito de Batas Blancas del CDI UD-291 del Estado de Bol√≠var rinde homenaje a nuestro Comandante Ernesto Ch√© Guevara ejemplo de internacionalismo y de entrega ante el mundo #CheMedicoInternacionalista @Cubacooperabol2 @cubacooperaven @AdanVillavicen5 https://t.co/Jx623bTNy4,67223,62436,16614,146273
846,"@EfectoCocuyo Se recibe, desde cualquier banco, pero solo se puede transferir UNICAMENTE  A CUENTAS BANESCO PANAMA, osea uno con el dinero alli preso no puede transferir a otro banco ni nacional o internacional... Eso es una locura",31400,41141,17011,89552
847,"@SacmexCDMX Ah√≠ desperdici√°ndose y en Pedregal de Santo Domingo, calle de Jilosuchil n√∫mero 54, no tenemos agua. Y no me comenten que haga el reporte porque ya lo hemos hecho y no tienen para cu√°ndo mandarnos la pipa o decir que ya tendremos agua.",52966,4107,16636,73709
848,"Norma Trevi√±o realiza pega de calcas y entrega de propaganda en transito crucero
https://t.co/aEpM9qhv6p
#PiedrasNegras #Pol√≠tica https://t.co/tWqMGuu3pD",66619,10955,98777,176351
849,"#Falc√≥n - Gandoleros y transportistas, inconformes con cantidad de gasoil https://t.co/BMPxms9Cos",69634,66400,98041,234075
850,@Joseruj1801 Te dije que soy de Falc√≥n-punto fijo... la foto fue en un fundo en Santa Ana,40800,38384,30100,109284
851,Acaba de publicar una foto en Venezuela estado-falcon https://t.co/n6zq2MBdQk,17462,70815,96670,184947
852,"#18Oct | Vacunaci√≥n contra la fiebre aftosa ser√° hasta el 15-Dic | #Carabobo

https://t.co/6yGxB9TCGQ",48621,76479,6543,131643
853,@VenezuelaSaime Buen d√≠a necesito hacer una denuncia relacionada a la mala intenci√≥n de los funcionarios del saime los guayos de Valencia Eso Carabobo como se procede ????,93376,80300,61851,235527
854,"@Javierito321 Jajajaja en el estado bolivar un carro de 60 litros sale en 240$, a 4$ el litro",74332,18385,11477,104194
855,"Acaba de publicar una foto en San Juan De Col√≥n, Tachira, Venezuela https://t.co/WBvHXxVqTL",39263,74145,72474,185882
856,"Proyecto y propuesta de Escudo de Armas para la gran ciudad de Valencia, por el Artista Pl√°stico y Her√°ldico V√≠ctor M. Mart√≠nez, exaltando El Pasado y El Porvenir de La Ciudad, Glorioso Pilar de La Historia Nacional, dise√±o arte #Heraldica #Heraldry #Carabobo #Venezuela üíóüáªüá™üíó https://t.co/wJita6tS9K",91066,47861,99308,238235
857,PORQUE LA PAGINA DEL BANCO NUNCA SIRVE????,4652,18398,65688,88738
858,Liberar√°n mosquitos Aedes aegypti para controlar enfermedades en los Cayos de Florida https://t.co/CENmv4Wttq https://t.co/d5EcwtgoaQ,93804,7548,12212,113564
859,Yuliana Mart√≠nez a mi igual. Me dijeron que fueron compras que hice el 15 pero yo no hice ninguna compra con esa tarjeta ,60541,37807,35658,134006
860,"@WillamsGonzale9 @cfalcon3112 Yo lo que veo es que tienes como 10 errores ortogr√°ficos en un solo tuit. A lomejor ""la cava"" no ha hecho esfuerzos por fomentar una mejor educaci√≥n en Carabobo.  Digo YO",66485,75379,47229,189093
861,"@Edurodriguezg Guacara, Carabobo",31577,2871,73253,107701
862,Son unas basuras ,1802,24078,92549,118429
863,"@Banesco Sres 
@Banesco
 ayer fue cancelada la deuda de CANTV del N. 0239-2467460 jalaron la plata y aun no ha sido debitada  la deuda ,, quiero una explicaci√≥n al respecto...",706,97425,33880,132011
864,Daniel_RiosVE: CNBC: No estar vacunado contra el COVID-19 podr√≠a impactar tu bolsillo https://t.co/gvcsQtTi8L #DanielRiosTeInforma #Valencia #Carabobo #Venezuela,20349,44128,76662,141139
865,Buen d√≠a semana radical sin agua sin cable sin internet por cierto Gracias intercable por hacer caso omiso a mis reclamos Sra Arelis Mendoza CI:7009205 Resd Kiara La trigale√±a valencia Carabobo,7789,92826,30580,131195
866,Que falta de respeto de este banco!!! Queremos nuestros dinero ya! Que lo intervenga la SUDEBAN ya!!!,96480,69038,31748,197266
867,@ivanbarboza50 @jguaido No me jodas con un CNE hecho a la medida de nico ya todo eso est√° calculado d√≥nde pierdan va un protector como el Tachira Merida y nueva esparta,89682,89853,26736,206271
868,"#InformarNoEsDelito / Solidarios con la periodista @churuguara. El SNTP denuncia que funcionarios vinculados al gobierno de #Aragua hostigan a la periodista, corresponsal de @CronicaUno, a prop√≥sito de una nota que refleja la escasez de camas para atender a pacientes con Covid-19 https://t.co/bifOPSAlsK",6638,38166,66168,110972
869,#Sucesos | Crimen de padre a hija que conmocion√≥ a todo T√°chira  ‚§µ https://t.co/UjmQK8tTi9,32913,71625,48946,153484
870,"Gente no se olviden, si en venezuela no fuera existido el hijo de las tres mil putas de Chaves. F√°cil los destinos tur√≠sticos m√°s viciamos fueran adicora y todas las playas de Venezuela en ves de tulun y Canc√∫n, buenos d√≠as !",61747,11624,91672,165043
871,Primer ministro de San Vicente anuncia que solo vacunados podr√°n evacuarse tras la erupci√≥n del volc√°n https://t.co/FoshfZH9ey #INTERNACIONALES,80283,8852,35595,124730
872,"@Hidrocentro2011 8 dias sin agua el Trigal Norte Valencia Carabobo, ¬øqu√© pasa? ¬øPor qu√© no dicen nada?",92237,50195,2718,145150
873,"Acaba de publicar un video en Puerto P√≠ritu, Venezuela https://t.co/STnmG7kZqy",74114,33902,16632,124648
874,@NicolasMaduro buenas noches mi comandante le envio un saludo desde punto fijo soy un Soldado de. chavez tube en el 4f a pie de lucha y sigo en pie de lucha soy reservista y miliciano i sera asi mi comandante en jefe,1868,97126,69467,168461
875,#19Ago | Informa Lorena Evelyn Arr√°iz (@lorearraiz) que a√∫n persiste el apag√≥n en el estado T√°chira desde un poco m√°s de una hora y media #T√°chiraSinLuz,20780,22706,56868,100354
876,"1 semana #SinAgua en Valencia... 

Hidrocentro y Lacava guardan silencio: Zonas de Valencia y Naguanagua tienen casi una semana sin agua https://t.co/L6wKedCrT2",89178,5524,69394,164096
877,@dfrojass @NellyverLugo @FreddyBernal @Juntosxtachira1 @Redi_andes @ZODI_TACHIRA @TareckPSUV Tiene raz√≥n pero que m√°s hacemos los simples mortales que debemos esperar a que salga el listado para saber d√≥nde vamos a surtir y no estamos dateados,84574,33926,92469,210969
878,"@dumont_carlos @LucioQuincioC Narco.
https://t.co/nrsH9MgvTo",63447,36238,21232,120917
879,@garciabanchs Eliminar el BCV fomentar el libre mercado y Dolarisar el pa√≠s .,72908,36240,27498,136646
880,Detienen a seis miembros de una banda dedicada al tr√°fico de personas en Carabobo https://t.co/seKatjGyYv,35878,65782,47062,148722
881,"@secdespachogob1 @InsMamaRosaBol @DPDBolivar_ @FrenteBolivar21 @Mippcivzla @amarcanopsuv @OtbBolivar @delcyrodriguezv @GobJustoNoguera @ciangostura @PartidoPSUV La defensor√≠a de Violencia de g√©nero, empoderadas, trabajando en el mes Rosa... El Municipio Piar, laborando por nuestro municipio y el Estado Bolivar",55930,79051,44059,179040
882,√öltima semana radical de 2021: Carabobo tercer en mapa-covid-comunitario https://t.co/LoaPrtXRJQ #noticias #carabobo #venezuela https://t.co/55LnMdAvbB,69935,88710,63854,222499
883,"@rafaellacava10 buenas noches Sr Gobernador, que posibilidad hay de que hagan una investigaci√≥n y se resuelva el problema el√©ctrico de Carabobo, se va la luz todos los d√≠as hasta 5 veces al dia, se nos estan da√±ando los electrodom√©sticos y equipos electr√≥nicos. 1/2",5042,82708,40973,128723
884,"@ZODITACHIRA21 @dhernandezlarez @libertad003 @Redi_andes @juliaocaribe @GNB_tachira @AB_Guardacostas , , ,.,. ,..,
, .
,.  
.,.,.  ,",15408,51686,26147,93241
885,Acaba de publicar una foto en Venezuela estado-falcon https://t.co/T3UmoUpLHq,25449,49327,35897,110673
886,"El .@FalconGnbcz mantiene despliegue en el territorio Falconiano, para garantizar la seguridad y la salud del pueblo. #3Abr 
#SputnikVGarantizaVida
#GNBGaranteDePaz 
#FANBEnDefensaDeLaDignidad
.@NicolasMaduro 
.@cmdtegralgnb
.@LopezvargasR
.@GNBGDjuvenal https://t.co/1NlJzc6uxl",15011,49429,18047,82487
887,"Eso s√≠, Cay√≥ sombrero, chichirivichi, edo. Falc√≥n https://t.co/qkpBILgKFY",52768,10886,15489,79143
888,"@sisifrabeta Ahora ya no le paran al precio paralelo ... Ya salen  varios ü§∑ colocando en Stado de WhatsApp  Vendo a precio BCV.  

 Ahora s√≠ vamos por la tasa del BCV üòÇüòÇüòÇü§ì",96304,15637,19620,131561
889,PoliCarirubana detiene a un sujeto por maltrato animal https://t.co/Dx1yd6Xc5b,58260,71174,53598,183032
890,#14Oct Javier Bertucci: ‚ÄúCarabobo necesita un gobernador al que le duela la gente‚Äù https://t.co/e9Ho6wI4Sk https://t.co/8P2nfkhLgj,82415,90642,59095,232152
891,FALCONIA ü¶Ö https://t.co/nV3wEKQ9HH,40413,79006,40060,159479
892,"üëâEn @PacMesonesanz detuvieron a un cddno. solicitado por hurto calificado por el MP del Edo Carabobo. #CZAnzoategui #CMDTEPACChaguaramasAnz
#19Oct  #OlaDeSolidaridadPorAlexSaab
#PuebloUnidoAntiimperialista
@PresidencialVen
@PrensaFANB
@GNB_Anzoategui https://t.co/KLE24vMfMx",93846,83635,19128,196609
893,Las armas de Carabobo: La lanza https://t.co/WMhLUNNIlx,72447,77595,79889,229931
894,estoy cansado que mi personalidad se base en ser estudiante de la carabobo y sufrir porque estudio ah√≠,91096,4042,72706,167844
895,Como activo una cuenta digital ? Ya la abri pero cuando la quiero usar me dice que esta inactiva,50996,5522,32838,89356
896,@ChavezErtugrul Tanta celebraci√≥n por una bolsa?? Caramba vengase a San Diego Carabobo ac√° ni llega eso,96557,31169,97151,224877
897,"@maperezpirela @teleiguana Alguien puede @maperezpirela explicar la situaci√≥n de @SomosMovilnet_  @Info_Movilnet sin se√±al en gran parte del pa√≠s.
Carabobo est√° sin se√±al que irresponsable son con los usuarios",62525,35790,40569,138884
898,"@jaimeduenasp @ColmundoRadio B.noches l√≠der
Saludos desde San Crist√≥bal, Estado T√°chira-Venezuela.
Quer√≠a pedirte si nos puedes ayudar a difundir la campa√±a a favor de la sra Teresa Ochoa de Duarte, quien tiene fractura de f√©mur y urge su operaci√≥n.agradecidos por tu respaldo https://t.co/rxDl5EelpO",30199,70680,85279,186158
899,"@joserafaeldiaz Entre el Arco Minero y el Motor Forestal, cr√≥nica de una muerte anunciada para el estado Bol√≠var.",3574,44422,74345,122341
900,¬°Otro! Naufragio en Delta Amacuro suma cuatro fallecidos y 20 desaparecidos https://t.co/o3V1tPfiWp #noticias #carabobo #venezuela https://t.co/Pwwga9OfoR,5332,4649,132,10113
901,"O v√≠deo de um banquete de homens brancos ricos, imitando e zombando de Bolsonaro, presidente que ajudaram a eleger depois do golpe contra a presidenta Dilma, √© o perfeito retrato da elite brasileira, indiferente ao drama nacional e preocupada apenas com seus pr√≥prios interesses.",2954,492,69722,73168
902,"Mar√≠a Coromoto Sojo
C.I. 4.360.466
Desde San Diego Edo Carabobo
No me llega ning√∫n bono y desde Abril 2021 tampoco me ha llegado el bono de Guerra Econ√≥mica.
Soy de la tercera edad y pensionada nada m√°s https://t.co/xEI8KqORMj https://t.co/sutWQkdcjl",35025,75981,8259,119265
903,Que rabia.. Hasta cuando est√© mal servicio,92048,39777,73670,205495
904,"Seg√∫n ellos, podemos comprar y pagar, pero son incapaces de sbrir la mocho de plataforma. De paso, celebran la entrega de 100$ a algunos usuarios que y que cambiaron sus datos. No entiendo como lo hicieron si desde hace d√≠as no se puede efectuar ning√∫n tr√°mite. Ah, vean los n√∫meros de c√©dulas y casi todos van o comienzan con 20millones",10740,42096,1817,54653
905,Carabobo en 3er lugar con mas contagios de Covid y vamos para m√°s de una semana sin agua excelente gesti√≥n Gobernador @rafaellacava10,30601,12651,42834,86086
906,"Sin atajos, senderismo @rne sigue grabando en Gran Canaria. Hoy en el sur de la Isla. Nuestro gu√≠a de Arawak, Wilfredo, nos ense√±a el salto del pastor mientras descendemos de las cumbres. https://t.co/gf1zSoJt8t",41023,48462,83597,173082
907,"#EspecialVPItv |  La comunidad de Las Mar√≠as en Naguanagua, estado Carabobo, enfrenta un grave brote de leishmaniasis y los bajos recursos que perciben la mayor√≠a de sus habitantes dificultan su situaci√≥n.

üëâ https://t.co/cSkeD8e9mn https://t.co/PYE1YGSQ93",29851,66956,20754,117561
908,"Gobernaci√≥n del T√°chira contin√∫a atendiendo vialidad en las comunidades
https://t.co/Fitsk47acp
#T√°chiraNews #Noticia #Pol√≠tica #Venezuela #24agosto #Gobernaci√≥n https://t.co/ezhB0qd9mJ",85029,25484,36583,147096
909,"@Anibal56940122 @AdianezAlarcon @Leon087770274 @Rebeca_78 ü§£ü§£ü§£ü§£ü§£ü§£ü§£ü§£ü§£ü§£ü§£ü§£ü§£  Trabaj√© en un BCV aut√≥nomo‚Ä¶hasta q Ch√°vez quiso sus millarditos y acab√≥ con el BCV, perdimos la pol√≠tica de viviendas y la meritocracia, los jubilados apenas sobreviven. Ahora todos pelamos en igualdad‚Ä¶desde mucho antes de las sanciones (2017-2018)",61930,30091,41921,133942
910,"@dhernandezlarez @REDILL_Centauro @32Zodibarinas Barinas Cuna de nuestro segundo Libertador, Presente y siempre Consecuente, Venceremos
#ADI322SantaIn√©s
#APDIElCarmen
#Barinas
#FANB
#MiliciaBolivariana 
#PieDeLucha 
#LasSancionesSonUnCr√≠men",1367,81021,91784,174172
911,@FreddyBernal Juntos camarada Freddy Carnal lograremos la Gobernaci√≥n del T√°chira y por primera vez el Municipio Francisco de Miranda tendr√° un Alcalde Revolucionario. Venceremos!!!,54770,14264,75331,144365
912,Regresa la crisis de ox√≠geno y largas colas en centros de recargas en Carabobo https://t.co/uOn6iWrNz4,64445,46979,58347,169771
913,Hidrofalc√≥n tambi√©n se uni√≥ a dicha celebraci√≥n. üéäüéäüéäüéä https://t.co/NdbfITnQZH,43028,33643,91909,168580
914,"@BcodeVenezuela @andreinajromero @SudebanInforma @delcyrodriguezv @Mippcivzla @MinEcoFinanzas @VTVcanal8 @Yvke_Mundial1 @luchaalmada @bancaynegocios @globovision ll√©gale, a la agencia ubicada en multi jard√≠n da verg√ºenza muy deteriorada",56043,73426,19553,149022
915,"Inauguran nuevo Centro de Diagn√≥stico Precoz COVID-19  en Amp√≠es estado Falc√≥n

#11Abr

https://t.co/HtuOio8Qjb https://t.co/6ZbtpgErT8",39077,11802,41929,92808
916,"#30Mar @soypetitygarcia: ""Familiares le solicitan a la direcci√≥n regional de Cultura del estado #Falc√≥n apoyo con algunos m√©dicamentos. 

A pesar de la atenci√≥n recibida en el centinela de Coro, su familia y vecinos lideraron una campa√±a para adquirir algunas medicinas"" https://t.co/4XbH3h6Jls",19620,3692,4090,27402
917,"Jos√© Guerra: Si el BCV quema reservas para mantener bajo el tipo de cambio estar√≠a preparando una megadevaluaci√≥n #4Oct https://t.co/0lEREk2MnB v√≠a @elimpulsocom  Sabemos con qui√©n y a qu√© juega este economista de pacotilla,  lo que busca es llevar la contraria Y desestabilizar",39102,39295,74692,153089
918,"#INTERNACIONALES Bolsonaro compara medidas contra covid-19 implementadas en Brasil con ""dictadura venezolana"" https://t.co/F1AJgdq1ff",94527,52138,35917,182582
919,"@Hidrocentro2011 EXCELENTE, ahora ¬øPara cu√°ndo restablecen servicio en el municipio Naguanagua en Carabobo? Ya perd√≠mos la cuenta de los d√≠as sin servicio, ni siquiera son capaces de informar qu√© sucede.",68494,37336,15022,120852
920,@HIDROFALCON @AndresMiGente Aguaaaaaa para El Card√≥n Punto Fijo,54356,57720,71381,183457
921,#SUCESOS ‚ÄºÔ∏è || ¬°Tristeza! Chamito de 8 a√±os se ahoga en la fiesta de cumplea√±os de su primo en T√°chira | La iguana TV ü¶é https://t.co/cRLeJSDb9V,24428,22523,69033,115984
922,"@vozenardecida NOS DEJARON A M√àXICO patas p√† arriba y todav√¨a ""argumentan"" con noticias falseadas. Y lo que falta del bombardeo masivo de medios de comunicaci√≤n.
#CDMX #Mexico #Coahuila #Saltillo #Torreon #Monclova #Sabinas #Acu√±a #Sanjuandesabinas #Piedrasnegras #Sanpedro #youtubers",49068,57707,65973,172748
923,"Banco De Venezuela, necesitamos el dinero que  ha desaparecido de nuestras cuentas . Por diosssss hasta cu√°ndo hay que seguir esperando . ",66350,69660,28648,164658
924,En sinton√≠a de la @LaHojillaenTV por @VTVcanal8 desde Coro Estado Falc√≥n siguiendo la cuenta alterna del camarada diputado @SilvaHojilla #SputnikVGarantizaVida https://t.co/psnPowBhtM,2010,98404,60295,160709
925,"El control de precio es lo peor que pueda pasar, desaparecen los productos, lo mejor inundar al pa√≠s de productos importados para q computan y la supervison para respetar el precio del $ BCV . https://t.co/VVShdUI0QS",85506,24858,65470,175834
926,"AGUAS TERMALES
Ubicaci√≥n: Municipio Ayacucho-Estado T√°chira-Venezuela, San Pedro del R√≠o Plaza Bol√≠var V√≠a la POPA.
La Laguna Azul, La Cascada y la Cueva.
Aguas Azufradas. (Volc√°n Activo) 
¬®Cuida el Ambiente¬®.
Coordenadas U.T.M.
REGEVEN 18 P
Norte: 890.351,93 
Este:    796.187,36 https://t.co/hdmX5Ty2ou",89206,64556,87047,240809
927,#TENDENCIAS P√©sima broma: Influencer ingres√≥ a tienda con mascarilla pintada y ahora arriesga ser deportada https://t.co/g1ZRQRbz5l,15552,86283,62896,164731
928,"Mil 299 contagios en todo el pa√≠s, 176 de ellos en Carabobo, seg√∫n datos oficiales https://t.co/P0s2TPDLBp https://t.co/fpzTC8Pkk9",77773,72354,18176,168303
929,@Carabobo_FC @AraguaFC Vamos grana!!,74535,29078,82687,186300
930,"EN FIRMA CONTRATO ""CONSTRUCCI√ìN COMPLEJO DEPORTIVO ANFA"" - #CHIGUAYANTE üá®üá±üåü https://t.co/Um94lpSrMU",26119,50982,38057,115158
931,"El .@FalconGnbcz mantienen constante monitoreo del cumplimiento de las medidas de bioseguridad en el territorio Falconiano. #14Abr #FANB #GNB
#Nicol√°sMaduroEsPueblo
#GNByPuebloLeal
.@NicolasMaduro 
.@cmdtegralgnb
.@GNBGDjuvenal
.@LopezvargasR
 https://t.co/sJtDKoqGMr https://t.co/OMb81oxf76",13517,21389,89693,124599
932,"El papel redistribuidor es del Estado,quien debe ser garante de los derechos fundamentales e igualitarios es el Estado, no la empresa. Pero esto de Bol√≠var es puro humo, va uno a pedirle que desarrollen cada concepto y solo hay aire. Aire desperdiciado. https://t.co/kC15lqbB3c",58870,25275,42294,126439
933,@alcagirardota Por favor m√©tale el ojo el transporte carlos Arvelo que cubre ruta G√ºig√ºe edo Carabobo con Maracay edo Aragua hace un mes aumento pasaje el doble de 2 millones lo llevo a 4 y el d√≠a de ayer le aumento 1 mill√≥n m√°s total pasaje 5 millones en un mes,91488,91212,39653,222353
934,Cuenten conmigo. Ya est√° bueno de seguir esperando de brazos cruzados que otros nos resuelvan los problemas y dejando sigan destruyendo y arruinando a todos. Yo si voy a votar y mi voto ser√° por la UNIDAD. Para la Alcald√≠a de Caracas tenemos un candidato UNITARIO y √öNICO y ese es Tom√°s Guanipa.No te dejes enga√±ar.,43687,68098,27102,138887
935,"Centinelas del .@GNB41_CARABOBO, realizar√≥n la aprehensi√≥n de una (01) Cddna solicitada por el delito de estafa,A/O del @MinpublicoVE #GNBCaraboboSeguro
#16Oct #JuntosSomosM√°s #GNBD411Carabobo 
#VenezuelaTieneConQu√©
JuntosPuebloyGNBInvictos 
 https://t.co/KK09Ce3nsN",72186,91716,35133,199035
936,Jean Mary Curr√≥ y Alex Goncalves rompen el silencio tras pol√©mica por el caso Dave Capella https://t.co/fmxDek66o5  #ESPECT√ÅCULOS,261,62621,20731,83613
937,"Se desarrolla en el CDI castillito del estado bolivar, activo junenil d√≥nde los j√≥venes son el futuro de la Revoluci√≥n. #CubaSalvaVidas @AdanVillavicen5 @AnayansyPR @Cubacooperabol2 @cubacooperaven @CubaVa_Bolivar2 @KeylerING @Yordani12402517 @unidad_central @Javier33533196 https://t.co/sgzLpemDV3",45888,85344,70195,201427
938,"@ECOSDELTORBES @delcyrodriguezv Sra. Delcy Rodriguez, Vicepresidenta de Venezuela.Trabajadores de Corporaci√≥n de Salud adscrito a Gobernaci√≥n del ESTADO T√ÅCHIRA, solicitamos su apoyo y sea ordenado ante PLATAFORMA PATRIA, el pago de Homologaci√≥n del Acta Convenio de Mayo a Julio.",97771,25609,90558,213938
939,"Hoy presente en la victoria del @AraguaFC ante el @Carabobo_FC  2-1 con goles de Alfredo Stephens y Rafael Arace, para conseguir la clasificaci√≥n al hexagonal. https://t.co/Xc5OuwBhj4",8609,56977,35049,100635
940,"Extraordinario despliegue de motorizados, taxistas y camionetas, apoyando a nuestra pr√≥xima Alcaldesa Almirante Carmen Melendez mujer humilde y guerrera,  Caracas tiene con que ",23295,42260,96608,162163
941,"#9Octubre 
Rescate de felino domestico (Gato)
#Valencia #Carabobo
@BombVolCarabobo
@BomberoCarabobo @PCCarabobo @CentralReedan https://t.co/K4A8aZkBJs",75787,74207,26331,176325
942,@lafm Todos sabemos Q la citaci√≥n por parte del consejo de Estado al senador Gustavo Bolivar ser√° una patra√±a para enga√±ar a la sociedad bajo el argumento de acci√≥n de justicia pero el resultado ser√° la exoneracion al financiador del terrorismo urbano con dineros provenientes  del ELN,6221,83926,52700,142847
943,"Acabaron con todo, tanto as√≠ que ni personal capacitado tienen para restablecer el sistema.  Y para colmo se inventan teor√≠as de ataques terroristas ",54286,27459,1309,83054
944,"Vuelve a ver en #FrontRowStyle a Alexandra Pedregal directora creativa de la firma #Crasqi quien desde #Tulun exporta su l√≠nea de productos con coraz√≥n Venezolano para el hombre actual ¬°No te lo puedes perder!

Por #VePlus #DateElGusto https://t.co/osYfvpLRJl",97765,79669,25621,203055
945,"#DesplieguePopular2021 ya estamos engranando la plataforma comunicacional de los @MacCarabobo
en el marco del plan operativo @DesplipopularCB
rumbo a dar cobertura #21N #Elecciones2021 #Carabobo #Venezuela con la participaci√≥n de mas de 150 comunicadores populares https://t.co/iodd7h1qiu",94276,93050,41631,228957
946,"Contribuyente, NO te dejes enga√±ar con gestores. Nuestros servicios son gratuitos y de calidad #SeniatTrabajaParaTi @SENIAT_Oficial @ASIST_SENIAT @EGALLARDOB https://t.co/Q0LUQZ2VFw",29989,6122,76178,112289
947,"Lo recuerdo muy bien, eso fue en Punto Fijo y como me re√≠ con algunos disfraces. https://t.co/X5QLF8jOUJ",49537,76375,85970,211882
948,"@VoluntadPopular @SoniaMedinaSC El comunismo y fanatosmp empieza por ka casa de ella  su hermano es un arrodillado jala bolas del destructor del tachira, miserable.",32800,53911,36888,123599
949,Venezuela alcanza 1.853 fallecidos por Covid-19 https://t.co/0h7LcUa63q  #NACIONALES,37575,77507,948,116030
950,@NoticiasFalcon Un hombre maravilloso siempre que iba a la farmacia ya que era visitador me hac√≠a re√≠r con sus cosas que Dios lo tenga en su santa gloria,99122,58499,6842,164463
951,@escovargabriela @AdelaRivero Los datos reales (que es lo que sustenta a la ciencia) y no los credos de fe dogm√°tica en la mal llamada ciencia dicen que Zulia y Carabobo han reducido los contagios de COVID-19 mientras la region central los ha aumentado ¬øPOR QUE? Si respondo me cierran esta cuenta (ver imagen) https://t.co/PPkkvO7q12,83774,27345,97674,208793
952,@BcodeVenezuela Adem√°s a mi esposa mam√° y amigos le quitaron dinero y eso s√≠ no dicen nada @BcodeVenezuela  q pena eran un buen banco,51881,38179,66140,156200
953,"ALERTA 
Si ves en la autopista una gandola identificada con PDVSA no deje que se le acerque puede ser mortal para usted.

Vea c√≥mo por fallas mec√°nicas se incendi√≥ gandola cargada de gasolina en la Caracas-La Guaira, el parque automotor de PDVSA esta pr√°cticamente destruido https://t.co/OfXjWKAr79",75472,47247,26464,149183
954,"@Info_Movilnet soy de Cd Piar estado Bolivar, Cd 8873407, SERVICIO DE DATOS INTERMITENTE, Solo por poco tiempo",28511,62718,26440,117669
955,"card, con la misma l√≠nea telef√≥nica (en Naguanagua, estado Carabobo), para utilizarla en dos equipos que me fueron obsequiados, ambos procedentes de los Estados Unidos de Norteam√©rica, el primero un Samsung On 5, y el segundo un Samsung Galaxy S8. La situaci√≥n an√≥mala que est√°...",67150,77054,82770,226974
956,Desde Estado Bolivar cada d√≠a siendo mas Revolucionarios ya que el verdadero Revolucionario esta guiado por grandes sentimientos de amor #CheMedicoInternacionalista #HeroesDeLaSalud  @cubacooperaven @Cubacooperabol2 @AnayansyPR @AdanVillavicen7 @CdiCastillito https://t.co/V8yz6sPy1E,53716,6627,810,61153
957,"Jos√© Guerra advirti√≥ que la intervenci√≥n del BCV para bajar el d√≥lar podr√≠a producir una ""mega devaluaci√≥n""

https://t.co/gIdXwwKAvm",24320,42609,2384,69313
958,"Reportan baj√≥n el√©ctrico en los estados: 

Dto. Capital 
Carabobo 
Miranda 
Bol√≠var 
Zulia 
Aragua 
Barinas 
Lara 
Sucre 
Portuguesa

¬øInforma en que otro  estado presenta baj√≥n de luz? 

#Reportes360 #Sinluz #Bajon",53638,746,39850,94234
959,"Mucho cuidado üëÄ‚ùå | ¬øReiniciaron operaciones en Aeropuerto Internacional de Santo Domingo como dijo Freddy Bernal?  
 https://t.co/X89Wij8ONG",20389,36523,4437,61349
960,"Tenemos un indicador BCV, tenemos plataformas para que el petro y el bolivar convivan armoniozamente, el ESTADO tiene las herramientas para controlar la economia  #IndexacionSalarialYa  #DebateIndexaci√≥nEnAN #13Oct @NicolasMaduro @jorgerpsuv @tonyboza",85233,50412,45042,180687
961,En Sinton√≠a y en Victoria #21NVictoriaChavista  #PuebloProductor #25Agosto #Venezuela #Caracas #Zulia #Maracaibo #Carabobo #Valencia #Lara #Barquisimeto #Tachira #SanCristobal #Trujillo #Ahora #Ultimahora https://t.co/b2MdSTYOBh,99693,97044,42006,238743
962,@the_waro @CholoValderrama @parrandeador @Fabi8a Anzoategui no est√°.  El que di est√° es punto fijo falcon,66343,56243,4858,127444
963,"Nuevamente en el Pedregal de Santo Domingo, la #campa√±a es movimiento.
#MorenaVa https://t.co/6JF9qWmrQk",31157,83886,33535,148578
964,"Jacuzzi natural y cueva en Minas de Lobatera, estado #T√°chira Es #Venezuela 
(Foto: Traveling T√°chira en Facebook)
#9DeSeptiembre #TurismoNacional #rutas #viajes #viajeros #NaturalBeauty https://t.co/XKVGCvZgWA",17248,99882,38691,155821
965,"@CorpoelecCarabo @CorpoelecCarabo estamos sin electricidad desde las 2pm en Carabobo llueve y comienza la falla en el servicio, donde esta el mantenimiento preventivo sectores de Naguanagua afectados CR Las Palmeras CR El pi√±al CR Ticote Barrio la luz Colinas de Girardot",69604,13589,89179,172372
966,"@AndresMejiaV 15 minutos antes del comunismo
El¬†keynesianismo afirma q el Estado debe intervenir la econom√≠a para mantener  equilibrio y revertir ciclos d crisis
Afirma q el mercado no se regula d forma natural por lo q los Gobiernos deben minimizar fluctuaciones econ√≥micas
Bol√≠var Impriman $",99147,47376,47447,193970
967,"@Betta_ET Hay muchas mentiras en esa propaganda.
El Bolivar nunca ha estado por encima del d√≥lar.
La mayor√≠a de la infraestructura las termin√≥, m√°s, no las comenz√≥.
No hab√≠a libertad pol√≠tica y eso no es Democracia.
Adem√°s, ese dictador corrupto vivi√≥ sus √∫ltimos a√±os con dinero robado",73614,976,73699,148289
968,#NACIONALES Academias de Medicina y Ciencias: Venezuela atraviesa por el peor escenario epidemiol√≥gico https://t.co/FN2pW8jL0K,72879,74647,96473,243999
969,"Hoy T√°chira amanece sin gasolina otra vez. Ser√° que los nuevos gobernantes y la mesa de negociaci√≥n en M√©xico tomar√°n en cuenta que los salarios no son acorde al costo de la gasolina, donde es imposible pagar tranporte.",75655,22097,44242,141994
970,#Nacionales | Sistema del CNE impide a Daniel Ceballos inscribir su candidatura .-  üî∞ https://t.co/JP22cXXlAy,27406,67520,22923,117849
971,Carabobo | Escuelas estar√≠an exigiendo a los representantes llevar el material de limpieza e insumos de¬†bioseguridad https://t.co/8DlqSBhGlQ,8247,53691,1702,63640
972,Fan destacadoL deseo toda la buena suerte dl mundo en todas sus gestiones,20050,76426,62349,158825
973,Mi querida Almiranta un saludo Chavista y anti imperialista me dirijo a usted para comunicarle qu√© la UD3 de Caricuao se est√° callendo de abandonada ni una pinturita por ningun lado si ser√≠a tan amable de tomarnos en cuenta Que Viva la Patria,91290,58250,80739,230279
974,"@PetroDivisa ALERTA¬°¬°¬° Si, el precio del d√≥lar no ha cambiado y el BCV lo mantiene en igual precio ¬øPORQU√â INTERCABLE FACTUR√ì CASI EL DOBLE EST√â MES? El mes anterior factur√≥ 65 millones y este mes CERCA DE 104 MILLONES¬° Entonces cual es la ley, para esa ESPECULACI√ìN? INVESTIGUEN POR FAVOR ¬°¬°!",24560,7309,87031,118900
975,"@cmmzodic @NicolasMaduro @ZODI45_Carabobo @dhernandezlarez @wistohor @NicolasMaduro 
@wistohor 
#MiliciaBolivariana 
#PieDeLucha",58410,8619,44858,111887
976,@BcodeVenezuela Aqu√≠ en valle de la pascua tambi√©n se encuentran fuera de servicios todos los cajeros apesar de que hay 2 oficinas,38485,77897,33294,149676
977,"#RT @seniat_falcon: RT @NicolasMaduro: Aqu√≠ les dejo para la lectura y el debate, la edici√≥n N¬∞ 245 del Bolet√≠n del @PartidoPSUV, que resalta, c√≥mo con m√°s Poder Popular, m√°s producci√≥n, m√°s defensa y m√°s Revoluci√≥n, seguimos en victoria. ¬°Lee y Difunde!‚Ä¶ https://t.co/Vq8aG20SJV",61189,37752,48383,147324
978,@BcodeVenezuela Me pagaron la quincena m√°s otro pago del ministerio y cuando lo hiva a pasar al otro banco porque no tengo tarjeta resulta que el mismo banco se hizo un pago movil .y me dejaron sin dinero quien responde por esto ahora,52787,59982,80746,193515
979,"Desde la Secretar√≠a de Educaci√≥n de #Acci√≥nDemocr√°tica  en el estado #T√°chira y su Secretario @jarturomolina1 lamentamos el sensible fallecimiento del Dr. Alejandro Parra.

Qui√©n en vida fue Ex Embajador de Venezuela en Colombia en el primer gobierno de Carlos Andr√©s P√©rez.",17685,32428,70942,121055
980,"Plomo parque del este Carabobo #VenezuelaTieneConQue ü§°
#Venezuela https://t.co/Uqtzv5PRVY",66374,90914,82025,239313
981,"¬°Casi llega a sus casas! As√≠ evitaron vecinos de Fuentes del Pedregal que el incendio consumiera su patrimonio:

#Qu√©dateEnCasa #S√©FuerteM√©xico #DePisaYCorreTV con @PamCerdeira @ehiramhurtado https://t.co/1Rz3KjtxBp",99374,32846,83524,215744
982,@BcodeVenezuela BDV: Esto  me dice el banco  cuando trato de pagar Digitel y tampoco me acepta la actualizaci√≥n de pagos por Sns el monto de su pago de servicio supera los limites establecidos por ud. Valide e intente de nuevo. Inf: https://t.co/Xsuo0Pb335,37958,94492,16650,149100
983,"Inf√≥rmate en #SNE PiedrasNegras 
Agenda tu cita en üëâüëâüíªhttps://t.co/o0tiilEAFZ https://t.co/FTgaX5hrit",95353,19500,26479,141332
984,"Joven destroza auto tras aparatoso accidente y termina grave en PN.
https://t.co/CDu8ICyW4C
#PiedrasNegras #Policiaca https://t.co/HKS3IUU3S0",44366,92966,18607,155939
985,"Escuch√© a mi amigo, Fernando Orozco, quien vive en la colonia ‚ÄúJardines del Pedregal‚Äù, un tuxtleco como muchos, trabajador y echado para delante. Todos, igual que √©l, tenemos una historia que contar, experiencias y lecciones de las que debemos aprender y retos por enfrentar. https://t.co/iyiuixrTwK",22290,36972,63373,122635
986,"CDI Capacho Independencia.Estado T√°chira. Limpieza y embellecimiento en el CDI 
@CDI_capacho
#HeroesDeLaSalud
#ACubaPonleCorazon
#CubaPorLaVida
@cubacooperaven
@MINSAPCuba
@japortalmiranda
@PardoRegla https://t.co/5I2WCnWZ62",20540,23227,30179,73946
987,"@WilliamClaros17 @critico2_ He visto que aumentan el precio y colocan la tasa bcv. Si val√≠a 1$ ahora vale 1,5 o 2. Nadie va a trabajar para perder.",93115,7764,79899,180778
988,"#Vac√∫nateSinCita ¬´Bol√≠var renace con nosotros, vamos a convertir a este estado en potencia y ustedes van a acompa√±arme en este camino, ustedes son la generaci√≥n de oro de Ch√°vez y ahora de Nicol√°s Maduro¬ª. ‚ÄúEncuentro de las Fuerzas Revolucionarias Juveniles del estado Bol√≠var‚Äù. https://t.co/RlMVqptLny",96160,97662,63048,256870
989,"Beisbolistas en estado de ebriedad provocan choque carambola en Armando Trevi√±o.
https://t.co/H9BxCgjd1a
#PiedrasNegras #Policiaca https://t.co/WRh7Fg5DuY",51438,28994,18055,98487
990,"#Ent√©rate ||  A partir del primero de octubre circular√° el billete de 50 bol√≠vares de la Nueva Expresi√≥n Monetaria. En su anverso y reverso se encuentran estos elementos de seguridad. ¬°Con√≥celos!

#NuevaExpresi√≥nMonetaria #BCV #LasSancionesSonUnCrimen https://t.co/PlVktVJR7G",24006,41645,16958,82609
991,@elrodolfo1 Por cobrar a tasa distinta del BCV y remarcaje de precios.,70611,45302,57632,173545
992,@ariamsiap_ Punto fijo es un beta jajaja,11210,799,15324,27333
993,Daniel_RiosVE: Caso Gabby Petito: revelan el informe completo de la autopsia de la joven https://t.co/ntz1lCUr8V #DanielRiosTeInforma #Valencia #Carabobo #Venezuela,22805,16580,52136,91521
994,Esta es la primera de hoy #31Marzo del diario #NuevoDia del estado #Falcon https://t.co/YbTdfDfbZH,56974,98544,93932,249450
995,@YormanMonteroD @lialegre3065 @rafaellacava10 @avilaelguerrero @ZODI45_Carabobo peque√±as bodegueros ellos son victima de los mayoristas.,9464,43962,19776,73202
996,"@BcodeVenezuela @rmfinanzas Buenas tardes, me sale esto reflejado y no me dan respuestas, que pasa? Por que est√°n quit√°ndome dinero? https://t.co/wNPhCsL9G3",86887,3904,27012,117803
997,"@juanpreverol @CaraotaDigital El hecho que quede en medio de la nada no deber√≠a justificar que no tengan insumos... Y no se deje llevar por eso, aqu√≠ municipio Guacara- Carabobo el hospital est√° igual sin nada. Y as√≠ en todo el pa√≠s.üòü",88202,91590,34412,214204
998,"#NacionalesET Los estados Miranda, La Guaira, Carabobo y la capital del pa√≠s estar√≠an en una tercera ola de contagios
https://t.co/TNfgvteXUx https://t.co/rekOx6atGB",84223,38405,21026,143654
999,"O me responde a segundos de que le hable o me responde dos horas despu√©s, no hay punto fijo.",58860,36626,75428,170914
1000,"Culpa de la oposici√≥n falta de #agua y apagones el√©ctricos en #Upata estado #Bolivar. Saboteo, terrorismo, conspiraci√≥n y plan desestabilizador denunci√≥ alcaldesa de Piar en cadena radial este #27Sep.",4978,56207,86675,147860
1001,"@rumillaqta ... el fujimorismo sabe muy bien de donde sacarle dinero al estado y como hacerlo es su ""virtud"", tiene 4 sat√©lites en el congreso y tambi√©n su oficina de empleos en plaza Bol√≠var...por eso no quieren q su status quo se altere y seguir ""viviendo"" del estado",23458,56247,25283,104988
1002,"Contagios sin control
La nueva ola de contagios por COVID-19 en Venezuela empieza a extenderse. De acuerdo con el bolet√≠n de este 30 de septiembre, la enfermedad registr√≥ un pico de casos en estado Bol√≠var.",66984,7239,32951,107174
1003,"@eclecticomega @sisifrabeta Las reservas del BCV son pocas.
Adem√°s, la venta de √©sas divisas solo es para su c√≠rculo. 
Por ahora es s√≥lo un espejismo, Igual ning√∫n precio de producto lo mover√°n seguir√°n diciendo hoy a BCV ma√±ana a paralelo, valor de reposici√≥n, velocidad del bolivar y todas esas historias",97468,75447,61847,234762
1004,"@IsFreyax FREYA VISTE LO DE BERTUCCI, QUE BOLAS CON ESE TIPO
FUE A CARABOBO A QUE LACAVA LE DE UNA LIMOSNITA",90693,12289,52223,155205
1005,"Espectacular vista de la Pen√≠nsula de Paraguan√°, en el estado Falc√≥n - #Venezuela desde la estaci√≥n espacial.

#Peninsula #Istmo #EspacioUltraterrestre #EstacionEspacial #Geomorfologia  #Morfodinamica https://t.co/KiJ9LgNAVV",27065,21972,59023,108060
1006,"QUIEN CREA Q LA REVOLUCION ES UNA MODA ESTA MAS PELADO Q RODILLA DE CHIVO. LA REVOLUCION NO ES MODA, LA REVOLUCION ES UNA RAZON D VIDA, ES UN NUEVO ESTILO D VIDA, Y CON ELLA VAMOS HACIA LA REIVINDICACION D NUESTRA DIGNIDAD, PERDIDA POR CULPA D PAEZ, GOMEZ Y LAS PUTAS D PUNTO FIJO",62004,70647,69703,202354
1007,"Para los que andan tratando de lavarle la cara a V√≠ctor Clark porque sale junto a Chiche Smith, diciendo que el gobierno fue quien lo captur√≥, les recuerdo que Pablo Escobar, entregaba y mataba a sus socios.",56387,30434,42367,129188
1008,"The objective was not to remove the emergency orders, but it was an attack on a specific provision required things like contactless services etc that were (we said) inherently discriminatory in the absence of any other distinction between Arawak Cay vendors and others. (4/5)",80391,21075,23075,124541
1009,"@GNBCmdtGral @GNB_tachira @PresidencialVen @dhernandezlarez @PrensaFANB @libertad003 @GNB343VDLP @GnbGaranteDePaz @dcabellor @ConCiliaFlores @delcyrodriguezv @LopezvargasR üí•Lucha Frontal contra el Tr√°fico de Drogas  #19Ago #GNB #CEOFANB
#Ch√°vezPorSiempre
#GNByPuebloDeCh√°vez
#YoSoyFANB
.@NicolasMaduro .@GNBCmdtGral",46586,63089,96670,206345
1010,COVAX espera segundo pago de Venezuela para la asignaci√≥n de vacunas https://t.co/DyGxkqQH3e,88041,20004,96382,204427
1011,"Los ingresos de Piedad C√≥rdoba tienen varias fuentes asi:
Aportes de las FARC Y ELN como activista pilitica
Aportes del r√©gimen de MADURO
Mina de oro estado Bol√≠var de Venezuela
Es un personaje que no tiene que preocuparse por los pasajes o el da√±o del carro https://t.co/NFaXVjmvf9",22259,13258,91792,127309
1012,"@Banesco buenas noches, tengo rato tratando de entrar en la plataforma del banco y no he podido, necesito realizar un pago y es imposible, tanto por computador, como la aplicaci√≥n m√≥vil",53197,80248,66030,199475
1013,BCV actualiza tasa del d√≥lar oficial¬†(+Monitor) https://t.co/Sh5LWG4jjg,56405,51760,17624,125789
1014,Una pieza del cohete de SpaceX aterriza en una granja del estado de Washington: Un granjero estadounidense encontr√≥ parte del Falcon 9 en el campo. https://t.co/7dMP5Ns2UH https://t.co/a0aAdWvzgW,31933,49602,57233,138768
1015,"La seguridad de nuestra Patria se garantiza en la perfecta union c√≠vico militar policial por la Paz.
@NicolasMaduro @vladimirpadrino @dhernandezlarez  @Milicia_B1 @libertad003 @PrensaFANB @REDICentral_ @ZODI45_Carabobo https://t.co/t9JGO38sVn",94680,23531,78097,196308
1016,2. La Coordinacion de Mision Ribas Regional del Estado Falcon dona a la @ComunidadP_Coro material educativo y a su vez Semillas para articular #PlanSiembraPenitenciaria @mirelct @psuvaristobulo @GobVictorClark @MarelysCastro21 @IsabelG_DGREP,84253,81939,43672,209864
1017,Yo queriendo ir a Chichiriviche y no tengo dinero ni para ir a una playa de aca ü§°,69814,27056,74482,171352
1018,Dej√≥ pura miseria. No creo que descanse en paz.,87937,86481,25077,199495
1019,"Por cierto, para que vean lo escoltado estas elecciones ya hay gobernaciones y Alcald√≠as que fueron entregadas al sucesor del PSUV. Y de paso investiguen se√±ores periodista, aqu√≠ en Carabobo seg√∫n se comenta y chismorreo el calle a VOX POPULIX m√°s de un funcionario desde Alcalde",16981,93601,72296,182878
1020,"@MSVEnLinea @CarnetDLaPatria @MSVEnContacto Valencia, Edo Carabobo
No me llega econ√≥mica familiar https://t.co/BRDuEMozJU",62482,35860,59654,157996
1021,@RichardMendezTV Campeones mundiales y dos campeonatos de club suramericanos donde estuvo involucrados grandes salinistas del estado tachira. Aqu√≠ en SC es una pasi√≥n,77901,69549,9189,156639
1022,"@MSVEnLinea @CarnetDLaPatria @MSVEnContacto @NicolasMaduro @MSVCarabobo10 @PresidencialVen @ViceVenezuela @drodriven2 @jaarreaza @JeanMGProject @Mippcivzla @laradiodelsur üî¥#MSVEnLinea || Protecci√≥n social || Escaneo del @CarnetDLaPatria: 

‚û°Ô∏èMenci√≥n @MSVEnLinea | @MSVEnContacto 
‚û°Ô∏èNombre:DENNIS HERNANDEZ
‚û°Ô∏èC√©dula: V-12.427.171
‚û°Ô∏èDe donde nos escriben: TUCACAS PARQUE NACIONAL MORROCOY ESTADO FALCON

@NicolasMaduro ¬°AQU√ç NADIE SE RINDE! ü¶á",65053,67968,37488,170509
1023,@TarekWiliamSaab Se√±or Fiscal @TarekWiliamSaab nos urge  una audiencia con usted por estar afectados por procedimientos inadecuados en la Fiscal√≠a  somos del Estado Bol√≠var y tenemos m√°s  de 30 d√≠as  tratando  de hallar justicia  en Caracas,16924,73407,4373,94704
1024,"#RT @seniat_falcon: #FelizViernes | Buen d√≠a amigos contribuyentes, nuestras oficinas est√°n dispuestas a atenderlos #SeniatTrabajaParaTi @SENIAT_Oficial @ASIST_SENIAT @EGALLARDOB https://t.co/hVtIseAK4R",15937,59806,50038,125781
1025,"Alerta mundial en peligro extremo el Parque Nacional Morrocoy.
Im√°genes satelitales recientes se√±alan que la refiner√≠a El Palito contin√∫a derramando crudo en el Golfo Triste.
  https://t.co/jNLCiEjAfV https://t.co/pkrpM0U7cM",25028,71848,5051,101927
1026,@Bancaribe @SudebanInforma @BCV_ORG_VE el d√≠a de ayer bancaribe en horas de la tarde me hizo el reintegro correspondiente por el d√©bito err√≥neo üôèüèª‚ú® agradecida por tomar en cuenta mi caso y atenderlo. Dios les bendiga ‚ô•Ô∏è.,75064,39282,51500,165846
1027,"CDI Panamericano estado T√°chira 
M√°s que m√©dicos, ser√°n celosos guardianes de lo m√°s preciado del ser humano; ap√≥stoles y creadores de un mundo m√°s humano
#H√©roesDeLaSalud #ACubaPonleCoraz√≥n #CubaPorLaVida @cubacooperaven @MINSAPCuba
@japortalmiranda @PardoRegla @cubacooperaVTAC https://t.co/xHxHc6vy9u",410,10293,76659,87362
1028,@soydanycosmo Saludos Dany un Placer mi Nombre es Fernando como podemos Organizarnos aqu√≠ Carabobo de la mano del Gobernador con los emprendedores como los est√° realizando el Gobernador de Miranda,76066,94320,46512,216898
1029,"Si p√∫blica es la mujer
Que por pvta es conocida
Aquella m√°s corrompida
REPUBLICA debe ser.
Y siguiendo el parecer
De esta l√≥gica absoluta
Todo aquel que se reputa
De Republica ser hijo
Debe ser, a punto fijo
Un HDLGP.",58913,90536,88102,237551
1030,"M√ÅXIMO COMPROMISO PATRIO! üëäüáªüá™ #17Oct üé• El MG Juvenal Fern√°ndez L√≥pez @GNBCmdtGral, realiz√≥ visita en el Comando de Zona @GNB41_CARABOBO acompa√±ado del Cmdte de Zona GB @Rivera_bastardo
#GNBpaclaosuna213 
#LaVerdadSiempreTriunfa
#PuebloYCEOFANBVenceremos https://t.co/vqXk94Bfzb",80067,85730,53294,219091
1031,"Carabobo | Ampliaci√≥n de la avenida Pedro Melean de Valencia suma 11 a√±os paralizada

https://t.co/OmHN5GJPEY",81356,42530,78303,202189
1032,En #PiedrasNegras este infeliz hizo algo similar y el alcalde @claudiobresofic no hizo NADA https://t.co/4oYVp9lxvC https://t.co/Btb2P7teKI,33514,30010,42524,106048
1033,"lmurNta venga a bella vista parroquia el para√≠so nosotros tambi√©n somos Caracas tenemos problemos graves de aguas servidas calles destruidas √°rboles amenazando nuestras casas y nadie nos ayuda , por fa vis√≠tenos y ay√∫denos .",28916,31608,98710,159234
1034,"Buenos d√≠as @GuerriFem_78 te deseo un Fabuloso d√≠a. Somos Hij@s de Bol√≠var y Ch√°vez; Nuestra labor tiene un prop√≥sito m√°s elevado, su fin es conservar nuestro Legado y consolidar la Patria Grande en un Estado de igualdad en la Diversidad

Nosotros Seguiremos Venciendo por Siempre https://t.co/u6JUwJefqg",72981,85793,21196,179970
1035,"Concejal de C√°rdenas rechaza
posici√≥n del Hospital San Antonio

te invitamos a leer esta y muchas m√°s informaciones en nuestro portal digital üëá
https://t.co/Rqm1hiAjQF

#25Ago #tachira #lasPrimicias #Concejal #C√°rdenas #rechaza #posici√≥n #HospitalSanAntonio #RonyGuerrero #dinero https://t.co/uJLolFwUiI",98723,29716,30482,158921
1036,"que significa persona politicamente expuesta en la actualizacion de datos, que se debe colocar alli, para poder avanzar en la actualizacion.",60341,42004,88024,190369
1037,@NoticiasFalcon Vainas ver√©is dir√≠a Don Quijote...,19410,29649,52610,101669
1038,"√önete a nuestro grupo de Telegram!!! Escribe al privado y dejanos tus datos y los contactamos

SOLO PAREJAS NO SINGLES

solo parejas de los estados Carabobo, Aragua, Miranda, La Guaira, Dtto Capital https://t.co/S0lingmYFK",75663,64989,72583,213235
1039,#VotaNaranja #VoluntadPopular #Carabobo https://t.co/g5zP2EGUxu,84527,76552,12827,173906
1040,"Centinelas del @GNB41_CARABOBO, realizaron pr√°ctica y demostraci√≥n de orden p√∫blico para as√≠ asegurar el bienestar 
del pueblo #Carabobe√±o. #GNBCaraboboSeguro
#12Oct
#Rebeld√≠aInd√≠gena
#PuebloUnidoyGNBInvencibles 
.@PresidencialVen
.@PrensaCmdteGral
 https://t.co/vbSn73swy8",92958,67576,88950,249484
1041,"#Nacionales| Gobernadora del T√°chira: No tener primarias es una conducta similar al chavismo

Lee m√°s #ElCandelazo üî• 
üëâhttps://t.co/wxMyPZID7G

#7Sep https://t.co/Ppv170mKTq",78575,82446,4446,165467
1042,"@BCV_ORG_VE  realiza  segunda intervenci√≥n en las mesas cambiarias para intentar frenar alza del d√≥lar paralelo,#30oct**  https://t.co/NTwst5vTlX",39464,64965,63308,167737
1043,Lo importante es divertirse ü§≠ @Carabobo_FC,24386,29709,87546,141641
1044,"@leopoldo14 @Kevin_VivasL Querido @leopoldo14 . En Carabobo vivimos un gran a√±o. Jugu√© casi todos los partidos, hasta que me romp√≠ el ligamento cruzado a falta de cuatro fechas para terminar el T.Apertura. Ese d√≠a √©ramos lideres. Ah, y no fui para hacer goles, pero ese d√≠a aporte un gol. Abrazo, campe√≥n. https://t.co/tdEPe9QyYB",32717,31557,31127,95401
1045,"La alimentaci√≥n no se detiene en T√°chira, en Agosto, un total de 370 mil 459 familias recibieron su protecci√≥n alimentaria, en los 29 municipios de la regi√≥n andina.
#ClapTachiraSoberaniaAlimentaria

@NicolasMaduro
@FreddyBernal
@BermudezJoseA
@Juntosxtachira1 https://t.co/thSg9PbmWc",81904,41207,80077,203188
1046,"BCV realiza nueva intervenci√≥n cambiaria este #11Oct y el d√≥lar paralelo abre contenido en Bs.4,06 https://t.co/2VZhRjyrOz.",81556,65911,78954,226421
1047,"‚ÄºÔ∏èCUIDADO‚ÄºÔ∏èPersona sospechosa tomando fotos de casas en Fuentes del Pedregal y entr√≥ a un edificio haci√©ndose pasar por inquilina, para tomar informaci√≥n de los que ah√≠ viven.                                 ALERTA TODOS!!! https://t.co/8x5Bfy9Lsd",10296,81638,73675,165609
1048,"Ellos controlan PDVSA, El BCV y los medios de comunicaci√≥n, ¬øPero la culpa siempre es del imperio, DolarToday, o Maria Corina? ¬øTu realmente crees que DolarToday controla la econom√≠a de todo un pa√≠s desde un app? ¬øen serio? https://t.co/cAHupFL8Ic",49743,8268,64824,122835
1049,@RedRadioVe @Soy_yo14 @BCV_ORG_VE Co√±o por fin los ineptos como que van a comenzar a trabajar. Gloria a Dios!!!,8918,73264,68422,150604
1050,Daniel_RiosVE: La Casa Blanca: los puertos de Los √Ångeles y Long Beach tendr√°n servicio 24/7 https://t.co/3MUxN7EoeU #DanielRiosTeInforma #GacetaCarabobo #Carabobo #Venezuela,50636,61278,14876,126790
1051,"@NicolasMaduro  llam√≥ a la consciencia en los pr√≥ximos 7 d√≠as de cuarentena , para los estados Miranda, La Guaira, Carabobo y Caracas,¬†Si vamos avanzando en la vacunaci√≥n y nos cuidamos, tu me cuidas, yo te cuido y nos cuidamos todos..!üò∑üò∑
#AlexNosUnioMas
https://t.co/wS6eH0pqsM",99,30730,30361,61190
1052,"#Carabobo En Los Guayos Renace la Esperanza con Jaime Torres Alcalde. #UnionProgresoLosGuayos
#UnionProgresoCarabobo Carabobo @ArmandoAmengual Gobernador.! https://t.co/HrP1pyLHY5",23186,68559,42545,134290
1053,"Plan Carabobo 200 impulsa y dignifica el Centro Hist√≥rico de Coro en Falc√≥n  

#Prevenci√≥nEnFamilia

https://t.co/5wQDGeQrcH https://t.co/qWXWdAJb2u",3962,74281,59814,138057
1054,#08Oct Seguimos incrementando nuestros #PieDeLucha  para defender nuestra revoluci√≥n @NicolasMaduro @vladimirpadrino @wistohor @ADI_Tacarigua @ZODI45_Carabobo @Apdi_losguayos @Apdi_losguayos @luis15candanga https://t.co/AQ0DWTvvza,57280,17148,55687,130115
1055,"#SEVENDE TERRENO DE 570M2 EXCELENTE UBICACI√ìN PARA USO COMERCIAL √ì RESIDENCIAL
#MLYNER

WhatsApp 04265613885

#Compra #Vende #Inmueble #Alquila #Hogar #PuntoFijo #Paraguana #Carirubana #PuntaCardon #Falcon #alquiler #Venezuela Masdival Rafael Rangel Buen Pastor Maite Delgado https://t.co/Ta5NmrYUW5",4641,97509,32237,134387
1056,"@Hectorpcho @SARGENTOCHALA @DirectorPolicia El juez federal Edwin Torres, en su fallo, asegur√≥ que los actores del Estado colombiano apoyaron las operaciones del Bloque Central Bol√≠var (BCB) ‚Äîliderado por 'Macaco'‚Äî ""mediante el intercambio de inteligencia, armas y uniformes militares""
~~~
https://t.co/RiVn5v9KbM",44753,61347,20303,126403
1057,"#familia ‚ù§Ô∏èüè°üèòÔ∏è en Rubio, Estado Tachira https://t.co/SJFV027VTH",40701,12255,86290,139246
1058,#NACIONALES Detienen a comerciante tachirense que golpe√≥ a un anciano por hurtar una compota https://t.co/hhnQKWjcdB,49985,71879,76037,197901
1059,Ataque tirrorista!! Fue que le quitaron el tirro a los cables del banco de Venezuela...,37806,73076,40917,151799
1060,"#T√°chira Un hombre de 35 a√±os de edad, fue detenido en la localidad de T√°riba, en el municipio C√°rdenas por Polit√°chira quien se hac√≠a pasar por funcionario de la GNB adscrito al Conas para exigir divisas a comerciantes de esta jurisdicci√≥n.
#18Ago 
https://t.co/WLj7pl2aWM",90061,72663,97531,260255
1061,"#26abr Hidrofalc√≥n inici√≥ plan de emergencia para suministrar agua en Tucacas #Regiones

https://t.co/bz2TRHnfL8",79093,7596,61309,147998
1062,"üáªüá™üíµ ECONOM√çA | Venezuela: Precio del dolar hoy 25 de octubre de 2021 - 9:00AM

BCV ‚û°Ô∏è Bs/USD 4,23
Today ‚û°Ô∏è Bs/USD 4,32
Monitor ‚û°Ô∏è Bs/USD 4,33

üì∞ #NoticiasWBDigital
S√≠guenos en Instagram üëâüèΩ https://t.co/RvKPHn8uyg",62035,10034,58629,130698
1063,"@onapre_oficial Se√±ores ONAPRE, Los trabajadores de CORPOSALUD T√°chira, luchamos incansablemente por la operatividad en las √°reas administrativas y asistenciales. Por ende, solicitamos la aprobaci√≥n de recursos: pago HOMOLOGACION ACTA CONVENIO del 17-6-2021",45442,34415,92726,172583
1064,"A ver te hago un resumen, yo he estado por la zona con seguridad privada (colectivos chavistas del 23 de Enero) hace como 4 a√±os... Las minas est√°n en el arco minero del estado Bol√≠var. Para llegar pasas por Ciudad Bolivar, en esa ciudad ya se acepta el oro como moneda de pago... https://t.co/lUOlYBqQpc",3965,99971,41592,145528
1065,#19Feb Hoy la Vicepresidencia de la Clase Obrera del PSUV en Jornada Virtual con los Equipos Promotores Bicentenarios de los Trabajadores y las Trabajadoras del Estado Falc√≥n rumbo al Encuentro Nacional a realizarse el 23 de Febrero. @SoyRevolucion4 @VicePSUVObrera @Mincyt_VE https://t.co/Ap1q45VxX2,97527,19197,52076,168800
1066,"One thing I love about my Arawak ancestry is being Turtle Clan. So the Turtle Clan were a ruling clan NOT because of warrior skills, but for being people who ‚Äúhealed‚Äù and ‚Äúkept records.‚Äù I mean not one ounce of this incarnation is an accident, not one.",39323,25361,64355,129039
1067,@GNBCmdtGral @GNB41_CARABOBO @Rivera_bastardo Juntos con el pueblo,87108,75619,25516,188243
1068,@soldefreitas_ @LagunaPower_ Debe ser algo as√≠ como quemar/eliminar el BCV JAJAJAJAJA,15586,21602,65137,102325
1069,"@cmmzodic @NicolasMaduro @ZODI45_Carabobo @dhernandezlarez @wistohor #MiliciaBolivariana en victoria
#PieDeLucha
#HistoriaDeLaMiliciaBol√≠variana
@Nicolasmaduro
@vladimirpadrino
@dhernandezlarez
@Libertad003
@PrensaFanb",603,74456,1474,76533
1070,Esos centrales del Carabobo hoy est√°n vueltos locos y desordenados,7208,69205,86436,162849
1071,"@TheRed_Shadow_ Red, en agosto del 76...una pepsi familiar (las de vidrio), un bol√≠var de pan franc√©s (ocho), dos bolos de mortadela (la de la pimientica, 12 ruedas) y una barrita de mantequilla, pa' cuatro panas hambrientos a la orilla 'e la playa en Puerto P√≠ritu, y creo que sobr√≥ un real.",2053,11361,23614,37028
1072,@Banesco @Keniapita Yo estoy ahora pagando por @MercantilBanco porque me estuvo sucediendo lo mismo y no se resolvi√≥.,14548,52102,59016,125666
1073,""" El desayuno de los lunes, 
se toma mirando un punto fijo, y pensando:...
¬øqu√© es lo que hiciste mal que no naciste millonario?""üòÇüòÇüòÇ https://t.co/y69Jk610I9",92414,69887,14915,177216
1074,Primero Justicia T√°chira acus√≥ a Laidy G√≥mez de representar a ‚Äúlos partidos CLAP y las tarjetas secuestradas‚Äù https://t.co/tCJ8NIE0bO,89776,8286,49462,147524
1075,"Unidad, trabajo y compromiso con el legado de quienes construyeron la Revoluci√≥n es el sentir de los colaboradores de la Misi√≥n M√©dica Cubana en Venezuela Estado Bol√≠var. #Aniversario61CDR  #CDRCuba #SomosDelBarrio  #ACubaPonleCoraz√≥n @cubacooperaven @AdanVillavicen5 @AnayansyPR https://t.co/6iWdf1TQEy",11201,95233,67277,173711
1076,Consejo de Estado mantiene la investidura a Gustavo Bol√≠var al no haber incurrido en falta legal https://t.co/9RvvfntkbS,36694,36936,5717,79347
1077,"El cambio es a partir del √∫ltimo d este mes  y hoy no e podido tener acceso a banca en l√≠nea,, no creo q sea  falso!",48011,25733,5488,79232
1078,"Se pudiera decir hoy comenz√≥ la campa√±a en el #Tachira.
Esta candente y la basura sirvi√≥ de combusti√≥n",20760,62556,32947,116263
1079,"Ma√±ana estar√© disponible desde la 1:00 pm a 9:00 pm @BuscoExcortMty 
Me extra√±an???? üÜòüÜòüÜòüôãüèª‚Äç‚ôÄÔ∏è
Pueden agendar desde hoy 
üí≥ cuento con terminal 
üí≥tambi√©n me pueden pagar con transferencia
ATM 
S√∫per motel 
Pedregal 
Mirador 
Plaza 2020 
Bego√±a 
Marbella (Santa catarina) https://t.co/7FYwaycq26",13196,35010,20143,68349
1080,Pancho P√©rez Lugo: Convertiremos a Naguanagua en el Emporio Comercial y Agrotur√≠stico de Carabobo https://t.co/6wO4XGZ9SY a trav√©s de @Carabobo es Noticia,29250,39457,61427,130134
1081,@luis_villegasr @sundde_ve @mincomerciove @NicolasMaduro @delcyrodriguezv @Mippcivzla @almacaracas @BCV_ORG_VE @JRioboVTV @ViceVenezuela @JuventudPSUV @nicmaduroguerra @PresidencialVen @EneidaLayaPsuv El precio del pasaporte en casi bs 1000 no le parece que debe ajustarse a un costo m√°s asequible a todos?  C√≥mo lo paga un pensionado?,11836,75626,69289,156751
1082,"@ReporteYa @churuguara Que cosa de loco es la Basura de gobierno el que hace el bien va preso .,y los que anda estafando como los militares y todos su basura lo felicitan",24767,73827,81556,180150
1083,@loader2019 @PetroDivisa Reportes del BCV..,7637,79276,41784,128697
1084,@NASA @NASASocial what is that gas/liquid coming out of the nozzles at the base of the Falcon 9 rocket?,32396,93355,25681,151432
1085,"@BcodeVenezuela No trabajan en radical, se cae la plataforma y pasan 15 d√≠as cerrados... Y de paso ""feriado""! No digo yo!",50748,98827,16493,166068
1086,@alexarzuaga2345 buena cabure,27814,25723,5815,59352
1087,@ashleycarolps Paraguana-Venezuela. Zona playera,10248,60038,79048,149334
1088,#Comunicado Vente Joven Carabobo: Tibisay Lucena es parte de la destrucci√≥n de los procesos democr√°ticos del pa√≠s https://t.co/kmTnEA5fMr https://t.co/UVmDmz2EJW,49298,91298,61716,202312
1089,"Q hermoso Gracias a Dios. Y nos recupere todo el tachera q es lo q necesitamos. Porq de verdad despu√©s de las guarimbas nos acabaron esta ciudad, como si la pobre tuviera la culpa. Jam√°s olvidar√© el tanque de guerra q dur√≥ tantos a√±os en la avenida Carabobo q desde los a√±os 60 no se quien coloc√≥ ese tanque. Sr. Bernal gracias por trabajar por mi tachera. No se canse p√≥nganos bonita la ciudad por favor q √©l tachira necesita el amor de todos los tachirences. La ciudad m√°s linda de Venezuela. ",9135,20946,75372,105453
1090,"Llevan 6 d√≠as sin suministro de agua urbanizaciones de Naguanagua, Estado Carabobo, mientras tanto, @Hidrocentro2011 no informa ¬øhasta cuando? @rafaellacava10",37178,69652,85481,192311
1091,"@PetroDivisa Pa√±o de agua fr√≠a el del bcv. El efecto resorte en cualquier momento volver√°. No necesitan poder pol√≠tico, buscan ganar dinero. Poder econ√≥mico.",52034,25901,52275,130210
1092,Daniel_RiosVE: Documentos: acusado de asesinato cre√≠a que el gobierno ‚Äúenvenenaba‚Äù a trav√©s de las vacunas https://t.co/zgqZ0zd5Wg #DanielRiosTeInforma #Valencia #Carabobo #Venezuela,75898,73853,53260,203011
1093,Bertucci promete ¬´Plan Gas Para Todos¬ª con bombonas antiexplosivas si gana la Gobernaci√≥n de Carabobo https://t.co/xjsbwNPzif,90101,44687,68573,203361
1094,"@periclesdavila1 @saltillotwit @ReyesFloresH @PRICoahuila Y C√íMO ES QUE EN EL RESTO de los puntos de vacunaci√≤n se realiz√≤ la inmunizaci√≤n sin contratiempos, bien organizados? DE PLANO ALGUIEN QUIERE DESCOMPONER LAS COSAS.
#Coahuila #Saltillo #Torreon #Monclova #Sabinas #Acu√±a #Piedrasnegras #covid #adultosmayores #CDMX #Mexico",65484,80628,62250,208362
1095,Hermosa fotograf√≠a de nuestra pen√≠nsula de Paraguan√°..!! https://t.co/bvNFcQoSZI,34500,20991,3697,59188
1096,A este paso me voy a graduar en la unefm primero de payasa antes que de m√©dico.,62778,43368,24046,130192
1097,"CAPTURADO lider de banda, por #GNB del #215TachiraGNB cuando intentaba huir hac√≠a Colombia por San Antonio del T√°chira.

#23Ago #GNB #CEOFANB
#SemanaRadicalConsciente
#GNBCuidaDeTiYTuFamilia
#YoSoyFANB
.@NicolasMaduro
.@vladimirpadrino
.@GNBCmdtGral 
https://t.co/tH73yGM1fL",20542,98620,8635,127797
1098,"@CorpoelecInfo Y este n√∫mero aplica para todo el pa√≠s o solo un estado, donde vivo tenemos deficiencia de electricidad ya desde casi un mes y todas las noches hay apag√≥n, San F√©lix Edo. Bolivar Urb. Jose Gregorio Hern√°ndez",18645,31769,69893,120307
1099,@SacmexCDMX seguimos sin agua en Jardines del Pedregal,7469,64164,12914,84547
1100,"#18Oct Seguridad en Centros Educativos! Funcionarios
@policiafla01 Realizan recorrido por las instalaciones de la Universidad de Carabobo en @LinaresPotenci1 manifestando todo est√° sin novedad y cumpliendo semana radical @NicolasMaduro @Zamora_PSUV #EpaVamosACuidarnos https://t.co/083wg64Fii",28120,90509,15964,134593
1101,"EFRINSURCA - PUNTO FIJO, VENTA DE REPUESTOS DE  REFRIGERACI√ìN EN GENERAL. DOMESTICA, INDUSTRIAL, COMERCIAL Y AUTOMOTRIZ #REFRINSURCA TODO EN REFRIGERACI√ìN EN UN SOLO LUGAR  #PRECIOS INSUPERABLES #LAS MEJORES MARCAS #REPUESTOS ORIGINALES #COMPRESORES DE NEVERA https://t.co/kJsIwqFIDw",26448,43394,75879,145721
1102,"Buen trabajo camarada @marcoscamposf_ !

Cuentas con nosotros la Clase Obrera Psuv San Diego, Carabobo #TrabajoEnEquipoTiunfoSeguro #SanDiegoTieneConQu√© #VenezuelaTieneConQu√© Venceremos! https://t.co/RZRhAYHuYj",47503,44249,71626,163378
1103,"La tasa del BCV se cotiz√≥ este 4 de octubre en Bs. 4.18, pero en los distintos comercios de Sabana Grande, en #Caracas, recib√≠an la moneda norteamericana por montos que iban desde Bs. 4.14 hasta Bs. 4.80. Te contamos qu√© pas√≥ con Traki: #5oct https://t.co/stvtvA96f6",61929,68753,75078,205760
1104,@EAristeguieta Aqu√≠ en Venezuela votamos pero no sabemos si el CNE respetar√° los resultados. En el Estado Bolivar gan√≥ @AndresVelasqz la gobernaci√≥n y no le reconocieron . Le entregaron a su candidato del PSUV . Hoy vamos a elecciones nuevamente pero pedimos al estado unidad para ganar espacios,54100,99710,97926,251736
1105,"#ENT√âRATEüì£| El #28Oct inicia el XV Festival Mundial de Poes√≠a de Venezuela üáªüá™ que reunir√° a los 5 continentes en el grito libertario de #Carabobo a 199 a√±os del poema: Mi Delirio Sobre el Chimborazo, del Libertador Sim√≥n Bol√≠var 

#Vac√∫nateEvitaElContagio https://t.co/Ki0SKZjQJQ",61905,29512,84908,176325
1106,"#DelegadaAN | Dip. @sirit_eliezer: ""No hay lugar a duda que el r√©gimen avanza en sus pretensiones en construir una hegemon√≠a comunicacional a lo largo y ancho de Venezuela"".",32277,9698,10424,52399
1107,"#√öltimaHora #Venezuela Freddy Bernal, diputado y candidato de la revoluci√≥n chavista, en el estado #T√°chira, expres√≥ en una rueda de prensa la posibilidad de adoptar el uso del peso colombiano como moneda oficial en este pa√≠s. 
#ATNdigital https://t.co/LunsfefcYs",66364,39466,45643,151473
1108,"El distribuidor Los Totumos en el km 31 de la ARC, adyacente al relleno sanitario La Bonanza y que representa la entrada a #VallesDelTuy 

Coloquialmente los conductores de Aragua, Carabobo y otros estados, se refieren a este como la entrada o distribuidor de #Charallave. https://t.co/FvEy9bPaRa",45270,22778,48216,116264
1109,Tienen que llevar toda la plantilla del deportivo Tachira representan mejor hasta con la fanaticada,60959,98205,43512,202676
1110,Fallas del servicio el√©ctrico son cada vez m√°s frecuentes en todo el estado Bol√≠var https://t.co/8s2vcSHzSX v√≠a @DiarioPrimicia,35448,33588,2976,72012
1111,"@cmdtemiliciab1 @NicolasMaduro Comuna o Nada !!!
Pueblo Unido jam√°s ser√° vencido !!!
Operadora de RRSS del ADI 122 Urumaco",65320,33813,34237,133370
1112,A ELLOS: 200 VECES DESDE EL 2017 EL BCV D√ÅNDOLE PLATA A FEDECAMARAS-ENTORNOS+MAFIAS LA √öLTIMA SEM 50 MILLO $. A NOSOTROS: SE PIDE UN HIJO E¬¥PUTA CR√âDITO O UN #BUSFIAO PA TRABAJAR Y COMER=SHAKIROS PAL PUEBLO LOS H E¬¥P https://t.co/T7jHf7ngoM,28886,33652,73953,136491
1113,"RT @biblewords3: #ENT√âRATEüì£| El #28Oct inicia el XV Festival Mundial de Poes√≠a de Venezuela üáªüá™ que reunir√° a los 5 continentes en el grito libertario de #Carabobo a 199 a√±os del poema: Mi Delirio Sobre el Chimborazo, del Libertador Sim√≥n Bol√≠var 

#23Oct https://t.co/u2i8SJuV3u",65837,71797,3692,141326
1114,Ya ten√≠a mentalizado que ma√±ana iba saliendo para Churuguara ü§°,82954,17915,39675,140544
1115,"@Patrici12317769 @GabrielCoronad1 @jheferson13 @cmxcol @mtruzmanp Claro, universidades pioneras, la central, La universidad del Zulia, la universidad de los Andes, la universidad central Lisandro Alvarado, la f√© Carabobo, que son las pioneras de la educaci√≥n profesional en Venezuela",42293,5133,24042,71468
1116,"OCTB 29-21 
Atentos 
SUBE el promedio del D√≥lar en Vzl a 4,61 Bs % 0.21
Fuentes Tasa Oficial BCV @DolarToday #Cucuta  
@Cotizaciones_ @Peso_Bs
#TasaPromedio #TasadelDia #Bitcoin #Paralelo s√≠gueme en instagram #camarados https://t.co/ajVpJl8hRT  #RT https://t.co/PpDgDtemXK",54826,59468,84297,198591
1117,"@13emisal @Nacional @CLUBRENTISTAS Ese racimo de jugadores que forman desde el punto penal, ayuda a los desmarques y dificulta al defensor. Para Rentistas la mejor opcion para defender ese tipo de centros es intentar anticipar con un jugador fijo en la zona del primer palo.",67766,81564,354,149684
1118,"CDI 19 de Abril.Estado Bol√≠var .Celebrando la Jornada Camilo-Che desde nuestro puesto de trabajo dando continuidad al legado que nos dejo nuestro Comandante.
#CubaPorLaVida 
#CubaSalvaVidas 
#CubaCoopera https://t.co/rH8JGJLHP1",48479,22107,14766,85352
1119,"La Gran Misi√≥n Vivienda Venezuela (GMVV) hizo entrega de 34 casas a familias integrantes de pueblos ind√≠genas del estado Bol√≠var, para alcanzar la cifra hist√≥rica de 3 millones 720 mil 150 casas dignas a los Venezolanos, Venezolanas y residentes en el territorio nacional. https://t.co/z4bSoFxkE8",50969,59573,91356,201898
1120,#19Oct  Siempre dispuesto a todo. #PieDeLucha  @NicolasMaduro @vladimirpadrino @ZODI45_Carabobo @ADI_Tacarigua @Apdi_losguayos @luis15candanga @wistohor https://t.co/5MiyRn8UCd,763,12390,11417,24570
1121,"@caraboboreporta Kit Nintendo DsLite por 2$, incluye: 01 Lector de Tarjeta MicroSD, 03 Protector de Pantalla y 03 L√°pices punta de goma. #Nintendo #DsLite #Game #Vende #VenVariedades #Carabobo #Valencia #SanDiego #mercadolibre https://t.co/wpBp7zm03J https://t.co/97aElCVMuO",45783,83679,95405,224867
1122,TRINCHERA TACHIRENSE: DEL ABSTENCIONISMO AL DIVISIONISMO: https://t.co/cr40c3ZXCh,12172,20641,32923,65736
1123,"Gobernador Omar Prieto inici√≥ Plan Quir√∫rgico Carabobo 200 para pacientes del municipio Lagunillas - https://t.co/Q8ptOFActP octubre, 2021 https://t.co/qnVyzZUlzY",37243,46332,18556,102131
1124,Patricia Hernandez a mi tambi√©n me paso lo mismo no me aparece el dinero ,56399,5501,54190,116090
1125,"Estado carabobo CDI Bella Florida .
Pasi√≥n, amor y altruismo puestos en funci√≥n del paciente para salvar su vida, as√≠ brindan servicios los internacionalistas de #Cuba #CheM√©dicoInternacionalista #H√©roesDeLaSalud #CubaPorLaVida #CubaCoopera 
@cubacooperaven https://t.co/UK0eHkspN1",85769,22641,52637,161047
1126,PROYECTO GUAYANA presenta a ELSIS MAESTRE una de sus diputadas que acompa√±an al Gobernador del Estado Bol√≠var PEDRO MATA en formula perfecta por el rescate del estado! Conocela! https://t.co/tpwtPMF1o3,19276,97836,81732,198844
1127,"‚ÄúWhat we do here at Arawak is not only are we a community radio station but we are trying to bring people of all ages into music.‚Äù 

India-Rose Kaur spent time speaking to the people involved with Arawak, a radio station dedicated to helping the area of Coventry. https://t.co/ZBLuKZ8igF",54821,47106,24530,126457
1128,"#AnthonyUribe | ‚ÄúIremos a Barinas con respeto, con profesionalismo, con tranquilidad a hacer un partido correcto para que las cosas salgan de la mejor manera‚Äù üéôÔ∏è https://t.co/LrMJ5JgGCX",9466,78484,12178,100128
1129,#6Oct | Jos√© Guerra advierte que intervenci√≥n del BCV en el mercado podr√≠a provocar una ‚Äúmega devaluaci√≥n‚Äù üáªüá™ https://t.co/6PhF3nKT4w,14622,52614,92365,159601
1130,@NellyverLugo @FreddyBernal @Juntosxtachira1 @Redi_andes @ZODI_TACHIRA @TareckPSUV En Bolivar la estaci√≥n de servicio Venezuela le toca la placa n√∫mero 3 porque el martes echaron 1 y 2,77532,55121,11526,144179
1131,"Escuche las √∫ltimas noticias minuto a minuto sobre temas de actualidad del T√°chira y el mundo. De lunes a viernes a las 12:00 del mediod√≠a, y nuevamente a las 3:00 p.m., La Naci√≥n Radio https://t.co/ypcE8izhwm , le ofrece la m√°s amplia y completa informaci√≥n. https://t.co/kF5kgUVggK",22427,7663,3443,33533
1132,Gobierno: Comerciantes deben vender a tasa de cambio del BCV https://t.co/PBz7Xq1MFC https://t.co/ART927DPIb,79892,32057,71297,183246
1133,"#OfertaLaboral Estamos tras la b√∫squeda de distribuidores exclusivos en La Prensa T√°chira. 
Si deseas aumentar tus ingresos econ√≥micos, comun√≠cate con nosotros y √∫nete a la gran familia de La Prensa. #20Ago https://t.co/25t9QzVJzB",43419,68000,15419,126838
1134,"As√≠ cotiza el d√≥lar esta ma√±ana:

‚è±Ô∏è 01/11/21 9:00 a. m. 

4,50 (Monitor) ‚¨ÜÔ∏èüìà

4,45 (D√≥lar Today) ‚¨áÔ∏èüìâ

4,38 (BCV) ‚¨áÔ∏èüìâ

Petro: 

246,17 ‚¨áÔ∏èüìâ",56649,11652,21662,89963
1135,@VTVcanal8 @EneidaLayaPsuv Estado Carabobo urgente no hay nadie ni gobernador ni alcalde q se aboquen a este problema los comerciantes est√°n cotizando el d√≥lar a 6 y 7 millones precios exorbitantes auxiliooooo el pueblo no aguanta espero lean mi mensaje,56553,14424,76812,147789
1136,"Humillante Copa Libertadores de @elClubOlimpia,  m√°s all√° de lo de Tachira y Inter horrible. Ni la camiseta Meta Sports quiero volver a ver en Olimpia. Un 2021 para el olvido,  volvimos al Olimpia 2004 para arriba.",80008,59059,43188,182255
1137,".üëë
#LOTTOREY
06/10/2021
2:30 pm
Sorteo#: 3532
22 Camello 

Quieres plata?JuegaLottoRey
juegal #Legal
#RT #RT  
#06Octubre
#Carabobo 
#Zulia 
#Caracas 
#margarita 
#anzoategui 
#porlamar
#bolivar
#aragua 
#oriente 
#maturin 
#cantaura
#Falcon 
#Ecuador https://t.co/Od2JIt6zIP",65374,52118,55440,172932
1138,Hiperinflaci√≥n en Venezuela depende del BCV https://t.co/fjpl0FcBYH,30238,54744,94157,179139
1139,"Sonr√≠ele a este martes y disfruta tu d√≠a. 
Vamos #coNTodo #PiedrasNegras https://t.co/hjXpau5IUS",257,73771,89026,163054
1140,"@iTS___CHOSO DIOS M√çO SI, VEND√çA EN CHICHIRIVICHE Y TUCACAS",8342,15329,27128,50799
1141,#Comunidad | Promovidas jornadas consulares en Maracay e Punto Fijo | En Espa√±ol:¬†https://t.co/anSe2HWnCl https://t.co/zT6O4oEgeZ,12516,16003,60428,88947
1142,"‚ÄúGobierno Nacional enga√±a a los trabajadores del sector p√∫blico‚Äù

https://t.co/lWVdnfPnJu",77403,25173,24471,127047
1143,"¬øY cu√°l es el peor #SAIME de todo el pa√≠s? SAIME LOS COLORADOS #Valencia #Carabobo una cuerda de incompetentes sociales que no saben atender al p√∫blico, groseros, mal educados, salvajes, la barriga les llega al piso y esa cara de malandros que tienen ü§¨ü§¨ü§¨",86857,46233,29948,163038
1144,"#Carabobo registr√≥ 93 nuevos casos de Covid-19 este domingo  #18Oct 

https://t.co/nCb9D9coG9",25573,99731,99818,225122
1145,"SIEMPRE HABLA PURA PAJA DE FRENAR LA INFLACI√ìN, PERO TAMPOCO LE PONEN CONTROL A SU D√ìLAR OFICIAL IGUAL CON LAS PAGINAS DEL D√ìLAR PARALELO CREADAS POR GOBIERNO NACIONAL QUE TAMBIEN DEVALUAN LA MONEDA TODOS LOS DIAS, ENTRE EL BANCO CENTRAL DE VENEZUELA ALEADOS CON LAS PAGINAS DEL",65776,2717,60848,129341
1146,"No la quiero,fue cruel con nosotros en cabudare eso Lara,7 horas sin luz todos los d√≠as,sin agua,sin gas,y la bolsa cada 4 o 6 meses,",21925,74414,88881,185220
1147,"#Pais||William M√©ndez, exalcalde del¬†municipio San Crist√≥bal, estado T√°chira, declin√≥ este viernes su candidatura a la gobernaci√≥n. Seg√∫n declaraciones a los medios, apoyar√° la postulaci√≥n de Daniel Ceballos. https://t.co/O3c31J01TM",52635,4631,52280,109546
1148,Se√±ores no sean ciegos.hay que votar y darle una paliza al gobierno.sin votar es c√≥mo perder por no presentarse al juego.asi no se gana.en Venezuela sacamos a los adecos y copeyanos.ahora nos toca sacar a esta gente y a todo aquel que no sirva sea rojo blanco amarillo verde morado del color que sea,84797,72978,80541,238316
1149,"El .@FalconGnbcz mantiene despliegue en el territorio Falconiano, para garantizar la seguridad y la salud del pueblo. #3Abr 
#SputnikVGarantizaVida
#GNBGaranteDePaz 
#FANBEnDefensaDeLaDignidad
.@NicolasMaduro 
.@cmdtegralgnb
.@GNBGDjuvenal https://t.co/1f8yR1keNn
#GNBApure",93435,94709,77016,265160
1150,"@PabloEchenique ¬øY podr√≠an de paso aclararnos cuanto nos cuesta al mes cada menor inmigrante no acompa√±ado, y cuanto una anciana dependiente?
Por saberlo, salvo que sea secreto de estado, como los viajes en falcon de Sanchez o el sueldo de la ni√±era de los Iglesias.",68283,16791,67594,152668
1151,"Camaradas Comorodos Camaredes #TROPA juas, juos, jues‚ÄºÔ∏èü§£üòÇü§£ @PartidoPSUV @PedroKonductaz @Smmar4F @4F_Mamba #VacunarseEsVida #EnVideo #EnVivo #ONCA #TuiterosPatriotas #CarnetDeLaPatria #SistemaPatria @BCV_ORG_VE #NotiMippCI #YoCuidoCaracas 
Brutal el Gentio en #USAFreeAlexSaab https://t.co/bzfKh40JoV",90889,82862,53309,227060
1152,"@VenezuelaSaime Buenos d√≠as, necesitamos  reprogramaci√≥n de citas perdidas por FALTA DE SISTEMA sede Los Colorados  Edo Carabobo.. Fecha 02 /09/21",6858,80351,65355,152564
1153,"Todos son perfecto complementos para nuestras recetas pero queremos saber a cu√°l team perteneces. ¬øA o B?ü§î

Comenta y al visitarnos no olvides adquirir tu preferido ü•≥üíØ

¬°Te esperamos!

#KromiMarket #Valencia #Carabobo #SanDiego #Tazajal #Naguanagua #Prebo #SabanaLarga #Parral https://t.co/rGIZb5uimg",83774,79698,72630,236102
1154,"Preguntas Frecuentes | Si usted posee una deuda por‚ÄØun pr√©stamo, el monto ser√° reexpresado‚ÄØsiguiendo los lineamientos de la Nueva Expresi√≥n Monetaria.‚ÄØ#Banplus #HacemosPais #BCV",69817,49353,6291,125461
1155,"Vi una campa√±a en Facebook sobre la situaci√≥n del complejo ""Los perozos"" de unefm y solo pude reconocer a los que eran los peores estudiantes xd, o sea, que quieres rescatar? Las casitas donde perd√≠as todo el d√≠a o la oficina del movimiento donde cuadrabas como sacar plata?",98576,12793,32720,144089
1156,@Cubacooperabol2 CDI El ROBLE Nuestro comandante m√°s presente que nunca con  el legado que nos ense√±√≥ desde el Estado bol√≠var CDI El Roble saludando el 61 aniversarios de los CDR https://t.co/1aMbJXnQdR,73459,58859,60587,192905
1157,@Nataliaay Saliendo pa‚Äô Pedregal!,52387,19969,10072,82428
1158,"#15Oct Hasta las 8:30 pm 6 protestas:

-Anzo√°tegui
-Bol√≠var
-Carabobo
-Lara 
-M√©rida
-Portuguesa

Motivos: 
Servicios p√∫blicos
Salud
Laborales 
Participaci√≥n pol√≠tica
Educaci√≥n

Foto: ""Di√°lisis ya"", protesta en Barquisimeto #Lara-@elimpulsocom
https://t.co/Tg91o7ptoE -@OVCSocial",37909,15410,2933,56252
1159,"#30Mar 

MUERTO el tercer implicado en el homicidio del oficial de Polifalc√≥n 

https://t.co/V5cbbeOe48",1535,77401,57683,136619
1160,"Invit√© a la gobernadora y autoridades de la gobernaci√≥n de estado #T√°chira a participar en esta mesa de trabajo; est√°n presentes Arturo Molina, jefe de Educaci√≥n  y Jos√© Olmos, Jefe de Pol√≠tica. 3/4 https://t.co/WlDspIKfK9",22285,68145,82606,173036
1161,tan bello mi alcalde por siempre de caracas ,34660,64496,97794,196950
1162,"@AlexCabof @Bolivar_Oficial La selecci√≥n deber√≠a jugar aqu√≠, ya que no podes aprovechar la altura, que nuestro fuerte sea la cancha en mal estado j√©.

No imagino que a Neymar le salga una bicicleta en el IV Centenario jajaja.",50081,92604,62318,205003
1163,Conoce los l√≠mites de las tarjetas de cr√©dito en Venezuela tras la reconversi√≥n https://t.co/pyoNglC0xv #noticias #carabobo #venezuela https://t.co/P12bN5xk8W,2776,12927,81277,96980
1164,"#BOL√çVAR | La Universidad de Oriente n√∫cleo San F√©lix, estado Bol√≠var, fue v√≠ctima nuevamente de un acto vand√°lico la madrugada de este martes por parte de antisociales.

‚úçÔ∏èüèΩ: @Yosoyjessa 

https://t.co/xbNBC6w5pK https://t.co/y5pQSjXidW",16757,21803,13080,51640
1165,"La #GNBFalc√≥n  Seguimos en Batalla Victoriosa Comprometidos en garantizar la Paz y Bienestar del Pueblo Venezolano.
#29Mar
#Cu√≠dateDeLaCovid19
#GNBAlertaJuntoAlPueblo
#FANBEnDefensaDeLaDignidad 
.@NicolasMaduro 
.@cmdtegralgnb
.@GNBGDjuvenal
.@LopezvargasR https://t.co/yq4filZIpx",64745,49596,86562,200903
1166,"CON M√ÅXIMO COMPROMISO PATRIO! üëäüáªüá™
#17Oct üé• El MG Juvenal Fern√°ndez L√≥pez @GNBCmdtGral, realiz√≥ visita en el Comando de Zona @GNB41_CARABOBO acompa√±ado del Cmdte de Zona GB @Rivera_bastardo.

#LaVerdadSiempreTriunfa
#PuebloYCEOFANBVenceremos https://t.co/VwlqTXWho5",33761,14987,4888,53636
1167,Ladrones devuelvan mi dinero y a todos los venezolanos que robaron HDP,59632,71277,9895,140804
1168,"La Presidenta del Comit√© de Acci√≥n Social de la #GNB, Dra. Madelina Gelves de Fern√°ndez,  visit√≥ los Centros de Educaci√≥n Inicial de la #GNB aperturados en el Edo. Zulia.

EN FUNCI√ìN DE JUSTICIA SOCIAL
#11Sep
.@GNBCmdtGral
.@GnbGaranteDePaz
.@GBcmdte21gnb
.@GNB_tachira https://t.co/iar5DSbMDn",58453,67024,43659,169136
1169,"@cmmzodic @NicolasMaduro @ZODI45_Carabobo @dhernandezlarez @wistohor Activos para la defensa integral de nuestra amada Venezuela. Lealtad. 
@cmmzodic 
@NicolasMaduro 
@wistohor 
@vladimirpadrino 
#MiliciaBolivarina 
#PieDeLucha",86596,57989,69857,214442
1170,@GustavoAzocarA Eso solo eran unos vueltos que se le quedaron al protector del T√°chira. Que ladronismo tan descarado.,21597,15745,71832,109174
1171,"Disc√∫lpame diosito, pero a mi no me gusto nadita Ad√≠cora üò≥ü§≠üòµ #Venezuela",33011,20248,11235,64494
1172,#SUCESOS Capturan a Ra√∫l Pargas se√±alado por femicidio agravado https://t.co/JVIt6Icmui,36119,22320,48185,106624
1173,@laidygomezf @LaDivinaDiva Ella es lo mejor que tiene la opo,17014,28968,94656,140638
1174,"Lo bravo aqu√≠ es que si otro banco hace lo mismo ya lo hubiesen intervenido ,Pero como son ellos mismos "" NO PASA NADA""",92458,91572,99748,283778
1175,"Desde anoche a las 9 pmen #Seminario #SanDiego #Carabobo se han dado 4 cortes el√©ctricos. Agua por pozos profundos, entender√°n. #SinAgua qu√© habremos hecho por ac√° para que nos tengan en esta agon√≠a diariamente? @CorpoelecCarabo @rafaellacava10 @leonjura ah! Pero quieren votos! https://t.co/Dv8JczwjGU",9857,37105,53659,100621
1176,@BcodeVenezuela Cuerda de Ladrones Ladrones Ladrones Ladrones Ladrones Ladrones Ladrones üò°,27335,15705,64075,107115
1177,Solo sirven para echarle la culpa a otros. Todo ea saboteo. No reconocen que son incapaces y negligentes. Siempre buscando culpables y nunca asumiendo sus responsabilidad ,46931,32901,60740,140572
1178,"Hola hola buenas tardes c√≥mo est√° ministra, feliz y bendecido d√≠a.  Para hacerle del conocimiento de algunas Alcabalas en Anzo√°tegui que no acataron la orden del presidente y de usted, siguen en las mismas condiciones, poner orden saludos",50588,36249,1160,87997
1179,"Entonces bien, entendieron que  gastar dinero en f√∫tbol es como gastar en mandar al ""loco de Aragua"" al ski ol√≠mpico... Se explica? o es necesario plastilina? En Venezuela NO se juega f√∫tbol ( exceptuado tachira que es Colombia) https://t.co/R9ssAWuHDj",19043,57368,21512,97923
1180,"@EAristeguieta Es un acto cultural que reafirma el estado de disimulo general en un pa√≠s que desde la muerte de Bol√≠var, ha sido modelado como un campamento militar, donde todo se hace ""mientras tanto"", ""pa ma√±ana"" o ""como vaya viniendo vamos viendo"". Somos un pa√≠s transitorio.",74807,53540,77249,205596
1181,"En funci√≥n de Justicia Social, el .@GNB_VCostera efectu√≥ donaci√≥n de 30 mil Lts de agua potable en el Edo. Falc√≥n.

#18Abr #FANB #GNB #GNBCVC
#PrevenirSalvaVidas
#GNByPuebloProtegido
.@NicolasMaduro 
.@cmdtegralgnb
.@GNBGDjuvenal
.@LopezvargasR
https://t.co/WU124sUmcn",99977,21921,97126,219024
1182,"@alexanderriera @ZamoraMatea13 @pasquicurcio @MariaesPueblo @AmalCandanguera @Jcvgvaliente @tonyboza @salasrluis76 @dcabellor @delcyrodriguezv @NicolasMaduro 14millones de contribuyentes amigo ni cuando vielma tuvo el Seniat en su mejor epoca Venezuela tuvo tantos, Venezuela es un pais informal solo en mi ciudad el 80% es informal que es la capital S/C estado Tachira el impuesto de ellos es la matraca de la GNB",70340,44447,44100,158887
1183,@Aleja4810 Yo de punto fijo,42413,59989,88022,190424
1184,"@juanpgarciac @StasKlymenko Que atraco, por 40$ en carabobo si es microondas puedes tener 6MB si es ftth pudieras recibir hasta 40MB",66044,83129,48696,197869
1185,@LigaFUTVE saludos desde Ciudad Bol√≠var.. el mejor extranjero es el paname√±o g√≥ndola el del deportivo T√°chira..,9990,85826,57805,153621
1186,"@Edurodriguezg #saludoplanetario desde Puerto Cabello, Estado Carabobo. Feliz y bendecido viernes para ti Eduardo y todo tus seguidores. Aqu√≠ les comparte mi mensaje del d√≠a: https://t.co/ClQiIfXFDQ",77397,98926,99842,276165
1187,@SacmexCDMX @PabloGomez1968 Mejor manden a su gente a abrir las llaves en Amp Jardines del Pedregal. De verdad. Cada mes es lo mismo.,15621,19197,55880,90698
1188,"#09Abr #Falc√≥n #Coro | Entre un 15 y 20% ha bajado la venta de pan 
https://t.co/xyE1Q41GZe https://t.co/dI4895Wk0D",78468,7217,19135,104820
1189,"#200A√±osBicentenario | Estudiantes del sector p√∫blico han realizado actividades que promueven el fervor patrio desde sus hogares.

https://t.co/RF5z4sbIxJ",52780,25425,74384,152589
1190,@ElNacional @TVVnoticias @EVTVmiami @osmarycnn @UltimaHoraLara @VPITV @NTN24ve @TuiteoCaracas @TachiraNoticias #Ccs @webnotitarde @Simonovis @traffiCARACAS #Maracaibo #Valencia #Carabobo @monitoreamos @Petare_Bombilla @Las2zonas #Zulia #LosTeques #Macarao https://t.co/YiwwULnTJX,30370,82945,49991,163306
1191,"@VictorRojasc @picsandvideos1 @jfacostaf @GabrielaBodu La cuesti√≥n es qu√© recibe el d√≥lar a bcv y venden a paralelo, as√≠ sea verdes en efectivo los reciben a bcv venden a paralelo, por eso yisus los ech√≥ de su templo porque son sendas lakras",52970,70994,84564,208528
1192,EN CARABOBO | Arrestaron a empleada del oncol√≥gico por hurtar insumos m√©dicos https://t.co/tt176ahTZS,54267,81289,89244,224800
1193,¬°Basta de etiquetas! Es hora de levantar la bandera de un cambio para nuestra Venezuela. Y en Carabobo queremos empezar a creer en ese cambio. #ChavistasConBertucci,21327,15351,41873,78551
1194,"#6SEP | As√≠ amanece el canal humanitario en San Antonio del T√°chira. Las personas usan esta v√≠a para poder cruzar a Colombia.

üì∑:@Diariocalle1 https://t.co/nZXMextyjd",84639,81380,31900,197919
1195,Cuente con mi a pollo almirante Carmen Mel√©ndez un cordial saludo ,73371,84164,95320,252855
1196,"#16agosto Buenos d√≠as #FelizInicioDeSemana para todos, en la @tachira_gmas seguimos trabajando y venciendo, rindiendo honores a nuestros S√≠mbolos Patrios y a la memoria de nuestro Libertador Sim√≥n Bol√≠var 
#LunesCivico
@FreddyBernal 
#AmemosAlTachira https://t.co/4ItxGSiz4G",16367,75437,60837,152641
1197,"Votantes en #Carabobo catalogaron proceso de votaci√≥n como r√°pido, sencillo y seguro durante simulacro https://t.co/xPIePS2NsH @ValenciaHoy https://t.co/DKnRs3jCiO",99474,71233,27220,197927
1198,"""Echar gasolina subsidiada en Venezuela, ‚Äúuna paridera‚Äù interminable"" https://t.co/cztQgMAhag #noticiasvenezuela #feedly",9721,86681,73721,170123
1199,"#04Oct 
#CulturaTributaria ü™ô
Amigo contribuyente ¬øsabes como hacer el redondeo? aqu√≠ @SAATELLARA1 te muestra como hacerlo. No te enredes, conoce la nueva expresi√≥n monetaria.
#RumboAlBolivarDigital 
#VacunacionAbierta 
@AdolfoP_Oficial 
@gobiernodelara 
@BCV_ORG_VE https://t.co/U8qE2GmSM7",55554,94527,3798,153879
1200,"#15Oct üìå PuebloYCEOFANBPorVzla || #GNBBol√≠var y funcionarios policiales realizaron despliegue de seguridad en el estado Bol√≠var.
#PuebloVencedor
#VacunarseDependeDeTi
.@libertad003
.@GNBCmdtGral
https://t.co/A2QsN0WLJa
https://t.co/0RDlnmfvz7",84836,18809,14297,117942
1201,@1Yasminvelasco Sin luz Caracas parroquia antimano,16932,31962,83362,132256
1202,Dirigente de Vente Venezuela denuncia que milicianos armados patrullan calles de Barinas https://t.co/XDDUEQX815  #NACIONALES,9303,56493,34827,100623
1203,Buenos d√≠as mi capit√°n aqu√≠ le dejo a ingri Guti√©rrez campeona de la vida super√≥ un c√°ncer. Es tercerisada en PDVSA Paraguan√° ayudela con los compa√±eros revolucionarios @TareckPSUV y @AChavezPdvsa y ser√° posible que le metan la mano camaradas @Johanjpetrolera y @GodoyCoromoto https://t.co/CweDJKYIrn,11584,41305,76365,129254
1204,"La #GNBFalc√≥n  Seguimos en Batalla Victoriosa Comprometidos en garantizar la Paz y Bienestar del Pueblo Venezolano #Cu√≠dateDeLaCovid19.
#GNBAlertaJuntoAlPueblo
#FANBEnDefensaDeLaDignidad 
.@NicolasMaduro 
.@cmdtegralgnb
.@GNBGDjuvenal
.@LopezvargasR https://t.co/yNi9nYS3fV",73957,79753,38576,192286
1205,"Psic√≥loga denuncia acoso por parte de hombre q se hizo pasar por paciente en Ccas. https://t.co/RsjDShZaWA 

Venezuela logra 2 medallas d oro, plata y bronce #Tokyo2020 https://t.co/GD5xspTjX2  

Asesina hija con la q ten√≠a 2 hijos? https://t.co/HOgilL5eqR",66912,69435,73290,209637
1206,"La #GNBFalc√≥n se encuentra desplegada instalando Puntos de Cierre y Retorno para supervisar el cumplimiento de la cuarentena radical¬†¬†üò∑ #21Abr #FANB 
#PrevenirPorLaVida
#GNBCuidaDeTiyTuFamilia
.@NicolasMaduro 
.@cmdtegralgnb
.@GNBGDjuvenal
.@LopezvargasR https://t.co/woMjHmaiNe",25071,68099,84989,178159
1207,"La #GNBFalc√≥n  Seguimos en Batalla Victoriosa Comprometidos en garantizar la Paz y Bienestar del Pueblo Venezolano.
#29Mar
#Cu√≠dateDeLaCovid19
#GNBAlertaJuntoAlPueblo
#FANBEnDefensaDeLaDignidad 
.@NicolasMaduro 
.@cmdtegralgnb
.@GNBGDjuvenal
.@LopezvargasR https://t.co/xSo1eemY1L",13937,66780,68379,149096
1208,"@Cancerbero822 @dw_espanol Los chilenos cuando emigraron por miles cuando la Dictadura de Pinochet llegaron por miles a Venezuela. Utilizaban los hospitales gratuitos, las escuelas gratuitas, y se graduaron en la Universidad Central de Venezuela y la Universidad Simon Bolivar de GRATIS
Vivieron del estado",64136,70681,16923,151740
1209,"M√©rida y T√°chira han sufrido de derrumbes de monta√±as e inundaciones en las zonas bajas, luego de que el caudal de agua de las lluvias se precipitara a las zonas residenciales bajas
 https://t.co/s4iZ0Ixj2g",32811,67230,66102,166143
1210,"@salaprensaCantv Se√±ores,CANTV, tengo m√°s de 3 a√±os,sin internet y m√°s de 6 meses sin tono,02418077641,Urb, palotal Miguel Pe√±a Valencia Carabobo",52805,20472,48087,121364
1211,"@lenelb1 Este tipo del video hasta hace unos dias fue gerente general de Traki y lo botaron por eso el  @sundde_ve cayo de sorpresa jajaja
@BCV_ORG_VE 
  Ahora fue contratado por los chinos y arabes asi q se jodieron  @sundde_ve , ya veremos el desastre de precios locos en $ en Diciembre",99851,17679,82221,199751
1212,Me quitaron 42 millones y todav√≠a no los veo por ning√∫n lado ,86667,88295,31296,206258
1213,"üó£Ô∏è ¬°ùêìùêéùêåùêÄ NOTA ! ‚úçÔ∏èüáªüá™
üëâUsa el tapabocas üò∑ y realiza el lavado frecuente de manos üôå. 

¬°La Prevenci√≥n es la mejor Vacuna!

#4Sep #GNB 
#Di√°logoGarant√≠aDePaz
#FANByPuebloDePaz
#CEOFANBPorLaPatria
.@NicolasMaduro
.@vladimirpadrino
.@GNBCmdtGral
.@GBrosalesmolina
.@GNB_tachira https://t.co/FUiXvl7KCU",31550,60108,47946,139604
1214,"@Maria_pacheco04 Existen variables, Primero no debi√≥ subir de esa manera, ellos hablan ahora de nerviosismo, pero s√≥lo lo usaron para el especulador intentar golpear la nueva expresi√≥n monetaria,en cuanto a su ca√≠da imagino el BCV inyect√≥ $ al mercado, las r√°pidas sanciones del Gobierno entre otr",38695,9994,1287,49976
1215,EN CARABOBO: 150 comercios fueron sancionados por aumentar precios ante la reconversi√≥n  https://t.co/jtFx1mf4en,12007,64299,80700,157006
1216,Abrir√°n corredor estudiantil en la frontera tachirense por inicio de clases presenciales https://t.co/scWvmd2T5j,58851,23326,17451,99628
1217,"@BcodeVenezuela @bcodevenezuela @rmfinanzasve 
saludo presidente bienvenido al banco, la Directora De la Capital 3 la se√±ora Aminta Zambrano junto a la Jefa pyme se han convertido en una pesadilla en toda la capital 3,le gusta maltratar humillara,amenazar, manipular y atropellar",86800,27177,68645,182622
1218,"Con el pago de tus tributos est√°s haciendo Patria. üáªüá™ M√°s que un impuesto, es tu deber. Declara y Paga el #ISLR tienes hasta el 31 de marzo. @SENIAT_Oficial @ASIST_SENIAT @EGALLARDOB https://t.co/2ibKt7O8hf",76157,67894,63632,207683
1219,"El @FalconGnbcz y @POLIFALCON en el sector agua salada, lograron incautar (2.204 panelas) de Marihuana, que se encontraba oculta en la zona. #27Abr #FANB
#AbrazaLaVida
#GNBCuidaDeTiyTuFamilia
.@NicolasMaduro 
.@cmdtegralgnb
.@GNBGDjuvenal
.@LopezvargasR https://t.co/xb9yQyD4Du",16929,45402,80165,142496
1220,"Pues eres subnormal y te leiste otro manga xD.  Los personajes son perfectamente desarrollados,  es el punto mas fuerte de la obra de hecho.  La historia sigue un objetivo fijo pero no es monotono,  porque cada enfrentamiento es diferente y cada demonio es diferente. https://t.co/WZSaBNQ7ql",18847,30886,23197,72930
1221,"Pero bueno eso y mucho m√°s lo van a poder leer en el art√≠culo que escribi√≥ @perecere para @raichali sobre el tema aqu√≠üëáüèº
https://t.co/yx3WBBX0JL",59593,87715,28787,176095
1222,"Gabriela Rivas A mi me paso alrevez, yo tenia 29millones y el dia que se cayo el banco en la ma√±ana yo fui a gastar ese dinero y habia dejado en mi cuenta 5millones osea habia gastado 24millones.. y entre hoy y tengo los 29millones, quiere decir q me reembolsaron mi dinero, bueno mi dinero no, ya era el de ellos jajajaja",45903,12967,31784,90654
1223,"Jornada itinerante de inmunizaci√≥n contra el COVID-19, mercado la Ermita, San Crist√≥bal
@NicolasMaduro 
@AlvaradoC_Salud 
@MinSaludVE 
@FreddyBernal 
@Juntosxtachira1 https://t.co/eKvQZpYGrJ",91821,17606,61995,171422
1224,"2021-03-04 5mm en Villa Gesell, Buenos Aires, Argentina #pluviomano #gestionagro https://t.co/QjxU1C7f2r @caburearg https://t.co/DzG3xqdA2R",92564,56529,75674,224767
1225,"Daniel_RiosVE: Cronolog√≠a del asesinato de Gaby Ramos, la locutora hispana baleada en Utah https://t.co/wgBl6ciuP9 #DanielRiosTeInforma #GacetaCarabobo #Carabobo #Venezuela",2185,97497,58375,158057
1226,"Acaba de publicar una foto en La Grita, Tachira, Venezuela https://t.co/Ung3a5m3AL",99281,2182,69285,170748
1227,"Somos una Radio Hecha con Pasion 

Transmitiendo desde San Cristobal Edo. T√°chira Venezuela 
@sinergia897 
#UnaRadioHechaConPasi√≥n 

https://t.co/R4CfzHXlRt https://t.co/D7n2Yt47ZA",91576,19039,87362,197977
1228,"En este sentido reconocemos la ardua labor de las #ZODI, quienes junto a la #GNB, @GNB_VCostera y #OSC, aportan resultados contundentes al Estado y tranquilidad de los venezolanos, ¬°Seguimos en labores de patrullaje y escudri√±amiento! #25Abr #GNBFalc√≥n https://t.co/AD6fcjF64S",48372,94336,48403,191111
1229,"@cmdtegralgnb @GNBZuliaOficial @dcabellor @libertad003 @PrensaFANB @vladimirpadrino @avnve @VTVcanal8 #22Mar 
¬°Juntos al pueblo somos garant√≠a de paz üëäüèª!
VENCEREMOS üáªüá™

 #FANB #GNB #GNBFalc√≥n
#RadicalContraLaCovid19
#GNByPuebloProtegido
.@NicolasMaduro 
.@cmdtegralgnb
.@GNBGDjuvenal
.@LopezvargasR
.@zodifalcon12 
.@FalconGnbcz",75990,46734,2254,124978
1230,"#22Oct | Javier Bertucci: ‚ÄúCarabobo necesita un gobernador al que le duela la gente‚Äù
https://t.co/gvFNS5ZH78",29022,73546,65862,168430
1231,A la oficina de Guacara del Edo Carabobo no llega ni tarjeta de d√©bito menos financiamiento para emprendedores ..,55999,91712,38956,186667
1232,"#ClubHipicoxTLT de punta a punta,les saluda Jose Ramos desde Punto Fijo,mi linea en el Clasico Apistos",17851,71189,94771,183811
1233,"@DhelizAlvarez COMO DICE EL PUEBLO EN LA CALLE HOY SE PREPARARON PARA RECIBIR LAS INSTRUCCIONES DE SU ALIADO EL GOBIERNO NACIONAL DE MADURO Y CON ALIANZA, COMPLICIDAD Y COLABORACION CON EL BANCO CENTRAL DE VENEZUELA A QUE PRECIO VAN A VENDER LAS DIVISAS AL PRECIO QUE LES DA LA",28015,38235,31076,97326
1234,"Desde un rinc√≥n del #Tachira le dicen: buen s√°bado.
PD: un caf√© tinto. https://t.co/jOYl4xwuDf",51536,99263,40778,191577
1235,"@gestionperfecta y por qu√© dejaron libre a V√≠ctor clark??
Y para cuando menestra le van a poner los ganchos al @rafaellacava10 
Esto tambien es contigo @tarekwiliamsaab https://t.co/VoUbDMxMRw",4904,16948,97697,119549
1236,Nueva Esparta desplaz√≥ a la Gran Caracas en casos y Carabobo cerca de 80 https://t.co/j7DSTjetiE #noticias #carabobo #venezuela https://t.co/8Y2CFlABo6,82300,99453,40969,222722
1237,Con Freddy Bernal Me Resteo ya me di permiso de tutearlo desde mi tuiwter ha demostrado que el pueblo Tachira lo quiere lo respeta y lo sigue a d√≥nde quiera q vaya Si bien es cierto q eso no es un factor para juzgar el desempe√±o puedo decir q si lo es el compromiso revoluci√≥nario https://t.co/lQyy6ptFRE,3041,71883,28245,103169
1238,Ya habilito la app del bdv pero desaparecio un dinero que tenia en mi cuenta...,56514,67146,60997,184657
1239,"Ciclista es embestido por una camioneta en la colonia Las Torres
https://t.co/dBrcjR3nOn
#PiedrasNegras #Accidente https://t.co/TJLe37LxuN",84777,30763,75202,190742
1240,@danirrooo Desde Hospital √Ångeles Pedregal. https://t.co/BAo82PvNoj,7527,5899,75710,89136
1241,"#GNBFalc√≥n, prestan Seguridad a las instalaciones de las plantas El√©ctricas en todo el territorio Falconiano.
#30Mar #FANB
#SputnikVContraCovid
#GNByPuebloEnVictoria
#FANBEnDefensaDeLaDignidad .@NicolasMaduro .@cmdtegralgnb .@GNBGDjuvenal .@LopezvargasR
https://t.co/b7FMlNA6mi",8344,69887,80107,158338
1242,EL TACHIRA ES UN ESTADO MUERTO EN VIDA CADA DIA MAS SOLO DESOLADO ES UN ESTADO SIN ESPERNZA YA PARECEMIS UN  PUEBLEJO LLENI DE BASURA DE INMUNDUCIA DE ABANDONO SIN COMERCIO NI FUENRE DE EMPLEO DE NADA NOS ESTAN AFIXIANDO TACHIRENSES NOS MUTILAN COMO PAIS Y COMO ESTADO,2743,82547,69748,155038
1243,"Federaci√≥n Venezolana de Estudiantes Universitarios en conjunto con PSUV, JPSUV, en la carga del 1x10 todo un gran equipo unificado para garantizar el triunfo de Angel marcano Gobernador del Estado Bol√≠var Sergio Hern√°ndez Alcalde del Municipio Angostura del Orinoco... https://t.co/yrD0shJka3",23194,75022,29051,127267
1244,Incautan entre T√°chira y Anzo√°tegui cerca de media tonelada de drogas https://t.co/DG13a2IwXz *,55981,73806,70244,200031
1245,"#27Ago #PDCRadio | @johanalvarezr: Nelson Becerra, ex alcalde del municipio Ure√±a en el estado T√°chira dijo 'yo soy un l√≠der de la revoluci√≥n'; ese es el argumento que utilizan estos 1/2 https://t.co/aKOB2Hdhet",20935,69816,99840,190591
1246,"La familia del preso pol√≠tico Francisco Pacheco vive en Carabobo y el est√° recluido en Ramo Verde, estado Miranda, a 2 horas y media en carretera. Su familia es de muy escasos recursos, sus hijos no lo han visto desde diciembre de 2020. 
#LiberenAPacheco https://t.co/uLaUY7YptA",25002,44387,17205,86594
1247,Dios permita que se arregle la plataforma del banco... ,36837,44947,71580,153364
1248,"CON M√ÅXIMO COMPROMISO PATRIO! üëäüáªüá™
#17Oct üé• El MG Juvenal Fern√°ndez L√≥pez @GNBCmdtGral, realiz√≥ visita en el Comando de Zona @GNB41_CARABOBO acompa√±ado del Cmdte de Zona GB @Rivera_bastardo.

#LaVerdadSiempreTriunfa
#PuebloYCEOFANBVenceremos https://t.co/fdAeX40emL",30789,87402,28885,147076
1249,"#1Octubre Devaluaci√≥n del Bolivar y Reconvenci√≥n monetaria (mas de 5 veces), aumento de la gasolina, destrucci√≥n del aparato productivo (seguimos importando mas que nunca), etc...Por menos que eso le tiraron un golpe de estado a CAP. #1Oct",43731,78127,31337,153195
1250,"@PanchoPerezLugo @raphany @naguanagua_unt @partidoUNT @unt_carabobo En cada calle, esquina y vereda de nuestra Naguanagua; al hablar de la #Unidad que lidera @PanchoPerezLugo y @ENZOSCARANO, la esperanza aflora a√∫n en medio de la frustraci√≥n ciudadana y desidia que han dejado por doquier los vampiros de Maduro. El cambio va y Unidos lo lograremos https://t.co/81agDWclPe",89912,73829,15054,178795
1251,"A este lo pueden enchufar en el BCV ya.

#Venezuela https://t.co/V4eoNKwc5F",37290,11802,48179,97271
1252,@NicolasMaduro camarada Presidente el d√≥lar paralelo se est√° tragando la reconversi√≥n por favor no permita que eso siga avanzando adicionalmente los precios han subido sin control la gran mayor√≠a de los comerciantes no acatan la taza del BCV,58799,99806,81460,240065
1253,"La verdad sobre el G4...

Daniel Ceballos: La MUD retras√≥ los anuncios para ir a elecciones y ser los amos y se√±ores de las candidaturas https://t.co/RHANrAtpfP",71587,77304,55578,204469
1254,@ENaguanaguense @Banesco @smejiasb Banesco en todo el dia ha estado caido @Banesco,61505,92192,86702,240399
1255,@IvanEReyes @Laura_Weffer En Punto Fijo hay sectores a los que llegaba el agua cuatro horas cada uno o dos meses. Hace m√°s de seis meses no llega en absoluto. Tienen que resolver con cisternas. Vaya negocito el que agarr√≥ un amiguito del r√©gimen!,65641,30152,69582,165375
1256,Gobierno de Colombia le responde a Maduro: Grupos criminales no tendr√°n padrino que los proteja https://t.co/O3OoZhVCjB  #INTERNACIONALES,56496,44984,1602,103082
1257,"#DiaHistorico

Un #4Oct, hace 9 a√±os, con 7 avenidas repletas de hombres, mujeres y ni√±os, acompa√±ando al comdte #HugoCh√°vez en el Cierre de la ""Campa√±a de #Carabobo"".

#UnidadParaLaProsperidad #TodoConAmor #Vacunaci√≥nAbierta https://t.co/P9IGdpfKSC",61545,34890,73482,169917
1258,Reportan volcadura de tr√°iler en #PiedrasNegras; chofer desaparece https://t.co/OkBx7eL7yy,10214,93096,4810,108120
1259,Daniel_RiosVE: ¬øDonde est√°? Dos muertes rodean la extra√±a desaparici√≥n de un peque√±o https://t.co/RgKvaX4EDW #DanielRiosTeInforma #GacetaCarabobo #Carabobo #Venezuela,86008,15012,73318,174338
1260,"@Pulento31762253 @irockwithjonas Creo que te equivocas @Pulento31762253, un ser humano que se precie de tal tiene la obligaci√≥n de ayudar a quien lo necesite y un cristiano debiera no s√≥lo saberlo sino predicarlo con √©l ej. X lo dem√°s, no creo que Bol√≠var haya estado contra Ch√°vez porque este √∫ltimo a√∫n no nac√≠a",24861,49673,62244,136778
1261,@Banesco Gracias por responder üòä,56986,66940,37210,161136
1262,@churuguara Que mame el guebo,37810,41913,90475,170198
1263,"Buenos d√≠as @quiskillosa te deseo un Fabuloso d√≠a. Somos Hij@s de Bol√≠var y Ch√°vez; Nuestra labor tiene un prop√≥sito m√°s elevado, su fin es conservar nuestro Legado y consolidar la Patria Grande en un Estado de igualdad en la Diversidad 

Nosotros Seguiremos Venciendo por Siempre https://t.co/WeRsWgQr3k",36596,74121,88981,199698
1264,"El @BCV_ORG_VE pretende solucionar la especulaci√≥n, robo descarado y la guerra contra pueblo venezolano ""vendiendo"" $50 millones a los mismas serpientes
Cuando entender√°n que esto no es oferta y demanda? https://t.co/952eAVnJB6",1956,56741,79531,138228
1265,Daniel_RiosVE: Tiroteo en Atlanta deja dos muertos https://t.co/xMMDcUUkw2 #DanielRiosTeInforma #Valencia #Carabobo #Venezuela,97548,3455,10125,111128
1266,"Hm,so i'm guessing the OP is getting changed when the Golem arc gets adapted considering Pascal Avaf,Lucifer,Yohken,and the Armor O.S are nowhere to be seen in the OP though Sati and Team Myooh got teased.
I'm surprised Matamune didn't get teased in the OP though.
#SHAMANKING",17875,7062,18984,43921
1267,Alguna verga por Pedregal para mamar y deslecharla en mi boca.,2471,89957,89791,182219
1268,"Ense√±√°ndoles a amar la naturaleza 
#BebeNucita 
Paseo en Familia
Tiempo de Compartir
#FamiliaRoblesRojas 
#FamiliaNucita en La Acequia, Barinas, Venezuela https://t.co/cT8IZLa2Z7",23740,43633,34828,102201
1269,"Detenido por los organismos de seguridad del estado Bol√≠var el comisario (r), Sa√∫l Cordero a quien le allanaron su casa por sospechas de conspiraci√≥n.",82266,88819,81139,252224
1270,"A Todos los diputados de la asamblea nacional. (√önico Indicador + BCV) Nadie debe compararlo, solo acatarlo. @jorgerpsuv @irisvarela @dcabellor https://t.co/5YppLWuSNo @NicolasMaduro @EneidaLayaPsuv @orlandocamachof 4",93215,10228,32632,136075
1271,Fue mayor la percepci√≥n de saturaci√≥n de hospitales en #PiedrasNegras: INEGI,39885,96014,75290,211189
1272,"@LuxManning @AdaAimee923 @SquidKidRy @ItsAhmeddddd @falconia_maxima Lux stop saying nice things about me, you're making me blush https://t.co/PggKFIL6zl",98620,33004,6800,138424
1273,yo aperture mi cuenta valide la huella y me sigue saliendo bloqueada q pasar√°,81883,60476,12633,154992
1274,Las llegadas de vacunas rusas a Venezuela son una burla. Otros pa√≠ses como Argentina y Bolivia reciben 800.000 de un trancazo y aqu√≠ movilizan un avi√≥n ida por vuelta para recibir la cantidad que cabe en una caja de zapatos. https://t.co/IxDnXwzZxi https://t.co/BryfYoXkls,50603,54199,4012,108814
1275,Fan destacadoAyuda ayuda ayuda tenemos 9 a√±os esperando y nada que nos dan la ayuda mientras que. Alos que no necesitan le adjudican en viviendo Edo lara regmer G√≥mez 04161283598,112,3034,65249,68395
1276,"Unidad, trabajo y compromiso con el legado de quienes construyeron la Revoluci√≥n es el sentir de los colaboradores de la Misi√≥n M√©dica Cubana en Venezuela Estado Bol√≠var. #Aniversario61CDR  #CDRCuba #SomosDelBarrio  #ACubaPonleCoraz√≥n @cubacooperaven @AdanVillavicen5 @AnayansyPR https://t.co/FjE7I26teM",90095,4857,42267,137219
1277,"Daniel_RiosVE: Precios de la gasolina seguir√≠an subiendo: c√≥mo puedes ahorrar al llegar el tanque de tu auto, seg√∫n CNBC https://t.co/mXYLbVWOpW #DanielRiosTeInforma #Valencia #Carabobo #Venezuela",32688,42602,83294,158584
1278,@negromangueraa Ya va van a mandar a Blade  cazar a dracula para Carabobo pero ese Blade est√° como diferente no se,47828,42199,52148,142175
1279,"Demostraci√≥n llena del fervor y principio Civico-Militar,  con la asistencia MG @Perez_Ampueda y MG Murga Batista,  Cmdte @REDICentral_, el GD Bustamante Pernia, cmdte @ZODI45_Carabobo y GB Jos√© Alfredo @Rivera_bastardo, cmdte @GNB41_CARABOBO.  
Leales Siempre... Traidores Nunca! https://t.co/Y57fMlWHJE",1483,39337,69045,109865
1280,Hoy es D√≠a Internacional del Agua @Hidrocentro2011 y varias zonas del Estado Carabobo tienen 5 d√≠as sin el preciado l√≠quido.,31776,78251,54475,164502
1281,Se√±or Bernal deveria de enfocarse de verdad en los problemas graves ya que se acordaron del tachira en plena campa√±a como siempre  pero yo ni que le pongan oro voto por ustedes me drvo a mis hijos quiero un futuro para ellos,7181,84121,20748,112050
1282,"#7Octubre #SinAgua 

@Hidrocentro2011 sigue sin suministrar agua #Naguanagua #Carabobo 

@rafaellacava10 @SoyGutierrez10",42263,80284,27027,149574
1283,"La #GNBFalc√≥n  Seguimos en Batalla Victoriosa Comprometidos en garantizar la Paz y Bienestar del Pueblo Venezolano.
#29Mar
#Cu√≠dateDeLaCovid19
#GNBAlertaJuntoAlPueblo
#FANBEnDefensaDeLaDignidad 
.@NicolasMaduro 
.@cmdtegralgnb
.@GNB_Lara
.@LopezvargasR https://t.co/NKwq9BSNZP",81577,82321,99442,263340
1284,"@NicolasMaduro si tenemos un Banco Central que rige las finanzas de mi pais, no comprendo porque no IMPONEN calcular precios a la tasa oficial.  Es que acaso forma parte del complot contra los venezolanos? Asigne un presidente del BCV con cojones carajo, ya basta!!!",17863,24518,39286,81667
1285,"El tipo de cambio publicado por el BCV es el promedio ponderado de las operaciones de las mesas de cambio de las instituciones bancarias. Al cierre de la jornada del d√≠a jueves 14-10-2021, los resultados son:

#MercadoCambiario #BCVüáªüá™ https://t.co/mBdyDXSkc5
@BCV_ORG_VE",40345,58415,98314,197074
1286,"@luisvicenteleon:   Oposici√≥n es Mayor√≠a en Edos grandes, ZULIA, MIRANDA, ARAGUA, LARA, CARABOBO, ANZO√ÅTEGUI, TACHIRA, MERIDA, pero divididos disminuyen chance, #G4 solo busca asegurar su fuerza, no ganar @lolelolay @ed_mundos @agasesores @jlff63taz @bellomc",46125,84929,85802,216856
1287,Saludos camarada con cari√±o y respeto muchas felicitaciones sabemos quer√©s una estraordinario mujer dios t  bendiga √©xito..... Buenas noches ,44274,52751,64243,161268
1288,"La #GNBFalc√≥n  Seguimos en Batalla Victoriosa Comprometidos en garantizar la Paz y Bienestar del Pueblo Venezolano.
#29Mar
#Cu√≠dateDeLaCovid19
#GNBAlertaJuntoAlPueblo
#FANBEnDefensaDeLaDignidad 
.@NicolasMaduro 
.@cmdtegralgnb
.@GNBGDjuvenal
.@LopezvargasR https://t.co/i91NbnGcsC",18496,92792,21493,132781
1289,OVV reporta 128 muertes violentas en Carabobo en lo que va de a√±o - https://t.co/4tNJA7sRAq https://t.co/lRe9maiPfb,49301,7386,23296,79983
1290,Voy a ti Julio para seguir cambiando a Valencia para mejor y seguir teni√©ndola bonita como ya la tenemos y mejorarla a√∫n m√°s para q siga siendo una referencia en gesti√≥n p√∫blica en el pa√≠s porque todo el mundo habla de ella. Aqu√≠ nadie se rinde. Q viva Carabobo ü¶áü¶áü¶á https://t.co/8qRiNVKWcd,17270,759,28270,46299
1291,@killitemprano Saludos. No consigo ese comunicado oficial en la p√°gina web del BCV. ¬øD√≥nde lo ubic√≥ usted?,83644,46123,71977,201744
1292,"Dispositivo de Bloqueo en todo el territorio Falconiano para las medidas Sanitaria y Prevenci√≥n al #COVID19. Cu√≠date üò∑. #19Abr #FANB #GNB
#AbrilDeFuegoPatrio
#GNByPuebloLeal
.@NicolasMaduro 
.@cmdtegralgnb
.@GNBGDjuvenal
.@LopezvargasR https://t.co/gCj7YnSyEd",36401,63685,91905,191991
1293,#EEUUSecuestr√≥AAlexSaab #VacunarseDependeDeTi #JuntosSomosM√°s as√≠ es. Venezuela sigue adelante. Tenemos con que. #CaraboboPotenciaEducativa #Carabobo s√≠guenos @tuiterosactivo @humbertocaldera @gabxto @AideeJimenezcal @Mippcivzla @NicolasMaduro üéâüéâüíôüíôüôèüéâüö¥ https://t.co/OLw19k9c3R,48514,35981,35223,119718
1294,"Carabobo: Autoridades detienen a grupo de personas en tres fiestas clandestinas https://t.co/LPR5di1ei9
 #SUCESOS",56326,37023,99075,192424
1295,Felicidades camarada desde sarare Sim√≥n Planas ,58496,59600,69558,187654
1296,EN VIDEO | ¬°Inesperado! Rescataron a serpiente boa del interior de un veh√≠culo en Carabobo https://t.co/zZIy7xRjWD,18181,27234,67048,112463
1297,"@ReporteYa  #SOSagua para la parroquia Antimano#, m√°s de 2 meses sin el vital liquido.",5924,24309,32627,62860
1298,"D√≠a 9: Colonia Lomas del Pedregal, Apodaca, NL. ‚òÄÔ∏è

En compa√±√≠a de mis amigos @SoyBenvenuttiNL y @EduardoFloresNL , visitamos a las vecinas y vecinos comerciantes de la colonia, donde escuch√© algunas de sus necesidades, muchas gracias por recibirme #AliEnAccion #El8xAli https://t.co/SjFAqyxWeU",33872,84987,92154,211013
1299,En el .@415gacm_lara hemos inaugurado el monumento Bicentenario de Carabobo para rendir honor a nuestro Cmdte Supremo Ch√°vez y a quienes orgullosamente han comandando esta unidad √©lite de la #41BrigadaBlindada ¬°El Tornado Artillero de la Patria! #FANB #VenezuelaTieneConQu√© #9Oct https://t.co/WKPxo2ihgM,60759,96559,54023,211341
1300,"#Fedeindustria Carabobo: encaje legal frena al sector productivo - Los pocos financiamientos solicitados no son entregados a tiempo; pues no hay liquidez para abarcar las sumas solicitadas.
 - https://t.co/imI4miHqKs

#EncajeLegal #EscasezDeEfectivo #SectorProductivo",30656,98254,52234,181144
1301,"Red flagüö© #3

Que sea de Punto Fijo.

(Si tuviste una novia de la pen√≠nsula, nawebona mano, vamos a beber juntos pa matar estas penas)",92198,12830,63061,168089
1302,"@InterCliente Buenas tardes por favor, ya cancel√© mi factura, y me est√°n cobrando  pague por banco Banesco,  y quieren cortar el servicio,  revisen primero. Contrato 0700147185",19956,90817,81466,192239
1303,PA ELLOS: 200 VECES DESDE EL 2017 EL BCV D√ÅNDOLE PLATA A FEDECLADRONES-ENTORNOS+MAFIAS LA √öLTIMA SEM 50 MILLO $. PA NOSOTROS: SE PIDE UN HIJO E¬¥PUTA CR√âDITO O UN #BUSFIAO PA TRABAJAR Y COMER=SHAKIROS PAL PUEBLO LOS H E¬¥P https://t.co/DRDGgorEBF,69997,70600,70373,210970
1304,Sinvema #Portuguesa #Carabobo #Trujillo #T√°chira #Cojedes #Anzoategui denuncia que #MPPEViolaDerechosHumanosq #MPPERobaSalarios @eduardopiate2 antes de #Apure #ReintegreSalarios A MilDocentesSuspendidos hace 5Meses y no pueden comprar #CanastaAlimentaria para alimentar su familia https://t.co/YP8ED78iw0 https://t.co/AyO5KMs6ue,57172,42938,87437,187547
1305,"Un brote de COVID 19 se presenta en la c√°rcel Pedregal donde 80 PPL mujeres dieron positivo para #Covid_19, ya se han tomado medidas por @INPEC_Colombia y S.Salud de @AlcaldiadeMed. https://t.co/TpMFVpmnYC",24012,78853,36134,138999
1306,"Escuelas abiertas..En los diferentes  municipio del estado tachira 1/09/2021 @MPPEDUCACION 
@ZonaEducTachira 
@NicolasMaduro
@yelitzePSUV_
@charlychaves
@COMUNIDADESED15
@edward_arellano
@SPETachira 
@FreddyBernal
@DGEFDMPPE  @DorisJi32185292 @arnaldo72086828 https://t.co/sp0yXtDjqa",73776,20148,8828,102752
1307,https://t.co/t1qNYWj2rg  sigue el link pa' que veas el d√≠a a d√≠a en Caracas y toda Venezuela. Esto es Los PoliBrujas! Suscribe #Venezuela #Caracas #crisis  #PNB #GNB #FANB #CICPC #26Ago #Cota905 #LaVega #ElValle #Ocumare #VallesDelTuy #PlazaVenezuela T√°chira Maracay Bello Monte,95434,19954,39625,155013
1308,@Banesco Gracias; respondido,37158,84822,47038,169018
1309,@carl_alberto12 @Asamblea_Ven @CarnetDLaPatria BIENVENIDOS AL CAPITALISMO POPULAR PACTO DE PUNTO FIJO 2.O #LaTraicionEstaConsumada,64452,62761,41098,168311
1310,#Sucesos | Abatidos tres delincuentes en Carabobo en operativo de rescate   ‚ô® https://t.co/o9pUhScD3L,94777,51564,77730,224071
1311,"1. Estudiantes de Merida, 35pts.
2. Deportivo Tachira, 33pts.
3. Portuguesa FC, 29pts (enfrenta a Trujillanos el 22/8)

De 3¬∞ a 1¬∞ en solo 4 DIAS.

üì∏ @NathalyAven

Tremendo lo del acad√©mico. LOS NUEVOS LIDERES DEL GRUPO OCCIDENTAL. #LigaFUTVEüèÜ https://t.co/uGaIEVzffd",40999,7835,30629,79463
1312,"Amigo Contribuyente, tiene dudas de c√≥mo realizar la declaraci√≥n del #ISLR ll√°menos, sin costo alguno, al 08000SENIAT (08000736428)y con gusto aclararemos su duda. ¬°No te quedes sin declarar, Evita las sanciones! 
@SENIAT_Oficial @ASIST_SENIAT @EGALLARDOB https://t.co/5ovfmjOu9R",13473,7212,66577,87262
1313,"@BcodeVenezuela @jennifercartall Me apareci√≥ este pago m√≥vil que no hice, est√° sin referencia no tiene hora.quedebo hacer ayuda por favor https://t.co/uPI2fbI7UJ",18601,22548,24183,65332
1314,Parroquia Unare desde las Colinas gracias a todo ese gran Equipo organizador. @AmericoDeGrazia pr√≥ximo Gobernador Del Estado Bolivar por @VzlaEcologico y @cchancellor_f  Alcalde de Caroni contacto directo cara a cara en las colinas de Unare que exige cambio de modelo https://t.co/XmgIV9h9Mg,20546,81476,72260,174282
1315,@BCV_ORG_VE Porque no se actualizan! No tienen tiempo /,64399,29900,4216,98515
1316,@BcodeVenezuela  caramba ese m√≠nimo a una tarjeta de 1 bolivar que pas√≥ ? porque no se equivocan y lo mandan a disponible https://t.co/odTZTJ8p0F,78644,57531,13563,149738
1317,Daniel_RiosVE: A los pu√±etazos en la c√°rcel: empieza juicio contra autor de masacre escolar por supuesta golpiza a oficial https://t.co/Uo9RLSkOxI #DanielRiosTeInforma #Valencia #Carabobo #Venezuela,15633,88545,13811,117989
1318,"Cerro la universidad del Zulia, cerro la aduana de Maracaibo,  fusion√≥ Zulia con Falcon,  excelente ¬° https://t.co/o9Ap4rXLYQ",43931,4348,49832,98111
1319,Jajaaja cdsm atentando y atentada contra este chavista. De por cierto quien esm jajajajajajaja baja el mejor blooper de la semana .  @Noticia_tachira @4F_Mamba @lubrio @traffiCARACAS @Hernancanorea https://t.co/NmGpGszzAg,39564,76704,22109,138377
1320,@chavistaganadr ¬øHay militares que hacen negocios en las bombas de gasolina? ... ¬øen serio? ... ¬øy que pas√≥ con los que piden para el fresco? ¬ølos que piden a los Ferieros de Merida y Tachira en las alcabalas que les dejen un saco de verduras?,92333,32073,40340,164746
1321,@NetUnoOficial Buenas sin servicio valles de camoruco valencia estado carabobo,19361,43949,98642,161952
1322,"#EspecialVPItv | Tramitar la c√©dula, una odisea que no distingue edad

En el estado Carabobo, Venezuela, las oficinas del Servicio Administrativo de Identificaci√≥n, Migraci√≥n y Extranjer√≠a (Saime) no se dan abasto para atender a la poblaci√≥n.

üëâ https://t.co/LRlTDTKA9N https://t.co/o8axkpp6tV",85650,58255,73090,216995
1323,"√âsta es una muestra de lo que l√≠deres CLAP vienen haciendo con el SECUESTRO de la MAYOR√çA de CONCEJOS COMUNALES con la COMPLICIDAD de ALCALDES y FUNDACOMUNAL creando grupos paralelos a la voluntad de las comunidades
Esto seg√∫n ocurre en CORO. FALC√ìN

.@ppt_uzcategui 
.@jpp_maria https://t.co/PHVyKEPidp",15506,53690,93216,162412
1324,"@jongmboa Jalate... pedregal del Carrasco... si llegas con 3 √≥rdenes de esas, te doy mezcal",7377,82559,39844,129780
1325,#ARC: Tramos #Aragua #Miranda y #Carabobo con fluidez vehicular en ambos sentidos.,42977,21849,50925,115751
1326,"@puhjih_vr @monitoreamos El Estado Comunal anunciado desde 1998, llevado al CNE y convertido en Ley por el mismo Ch√°vez como plan de gobierno, en 2012, mientras Capriles bailaba.

Es el Plan Nacional Simon Bolivar‚Ä¶ y siguen usando Caos para avanzar

El ‚Äûinvestigador‚Äú que se sorprenda es c√≥mplice",13152,37756,49267,100175
1327,@Rita_Capriti @churuguara @VoluntadPopular Porque los otros cuatro no pertenecen a la falsa oposici√≥n.,88586,34957,57277,180820
1328,@Marodmar13 @ramedumar @BCV_ORG_VE @MppComercioFal D√≥nde anda la nueva ministra de Comercio?,91608,54514,3193,149315
1329,@CorpoelecCarabo @rafaellacava10 @noticierovv apagon en Naguanagua Edo Carabobo.  Llevamos 2 horas y media sin energia electrica. Recuerden que hay pacientes con covid en los hogares.  Todos los dias en horas de la tarde quitan el servicio SOS.,84600,56702,87142,228444
1330,"Eso lo hace el poder de la fe y la oraci√≥n permanente. La mano de DIOS obr√≥ en este ser humano, a pesar de su longeva vida.üôè https://t.co/tEQg4HMt03",45634,84222,4968,134824
1331,"Ha estado guapo Falcon y el soldado de invierno 

#FalconAndWinterSoldierFinale https://t.co/PucpdyusKc",36012,98741,20458,155211
1332,"#T√ÅCHIRA | Escuela de Labores San Sebasti√°n en San Crist√≥bal se deteriora en medio del abandono y la indigencia

https://t.co/SuXEFuksGU",56832,42990,30463,130285
1333,@RevistaSemana Y bolivar defiende a sus hijos es un problema y eso que esos muchachos no tienen ni un solo esc√°ndalo ni legal ni civil pero cuando Uribe dice que est√° en riesgo su familia entonces ah√≠ si pobrecito cuando los hijos de Uribe han estado metidos en cientos de problemas legales !!!,59959,80091,64708,204758
1334,Iba por medicamentos a Colombia pero hall√≥ la muerte a orillas del r√≠o T√°chira https://t.co/dMNgRa4Hov      ¬∑,77392,69993,81855,229240
1335,"@luisbeltranf C√≥mo ve la participaci√≥n super dividida de la ""oposici√≥n"" en el estado Bol√≠var? Para m√≠ una gran üí©üí©üí©üí©",8553,92358,42393,143304
1336,"@fmonroy Saludos Fran, conoes la empresa Fibis, en carabobo? Internet por fibra. Saludos",10583,5579,26299,42461
1337,"Resalta CANACO operaci√≥n del 95% de negocios en PN
https://t.co/B07Wpx5lMn
#PiedrasNegras #Negocios https://t.co/iZCWxp5hl5",54817,9829,46672,111318
1338,@cmmzodic @NicolasMaduro @ZODI45_Carabobo @dhernandezlarez @wistohor Leales siempre traidores nunca,28153,83043,51397,162593
1339,"Intercambio y reconocimiento a colaboradores destacados con el sello 16 de Abril y Sello de Oro, con el acompa√±amiento a la Oficina de Atenci√≥n a Misiones, en el CDI La Manga, Ciudad Guayana, estado #Bol√≠var.

#CubaPorLaVida #H√©roesDeLaSalud #CubaCoopera 

@MINSAPCuba @PardoRegla https://t.co/KRnRyQ1eA7",77429,34948,2502,114879
1340,Con nuestro pueblo amado de Puerto Cabello. No tienen chance con nosotros los patriotas. Aqu√≠ nadie se rinde. Q viva Carabobo ü¶áü¶áü¶á https://t.co/9Ts5PFfdm5,81568,98983,70532,251083
1341,"@FanAurirrojo @Carabobo_FC Desde cu√°ndo no nos Ganaban un juego importante? Sapo .
Sin tribuna",56259,55556,75168,186983
1342,"#27Agosto la mejor cura ante el covid-19 es la prevenci√≥n, te lo recomienda: @laidygomezf, el @GobiernoTachira la presidenta @CeciliadeRoche1, los gerentes, jefes y personal de #Corpointa #QuedateEnCasa #LosBuenosSomosM√°s https://t.co/jxZW46qVxB",26906,3367,83454,113727
1343,Donde hago el reclamo de 113 millones que se desaparecio de mi cuenta,94426,12594,78607,185627
1344,"Estrangulan a una adolescente venezolana en Ecuador.
Roxely Guerra Tapia,de 17 a√±os del Estado Falc√≥n  quien desde hace varios meses emigr√≥ a Ecuador junto a su novio para buscar un mejor futuro.

Se sospecha del novio, ya que se encuentra desaparecido",25637,31395,32917,89949
1345,@salaprensaCantv Realice m√°s de 12 veces mi reporte hace 2 a√±os  y no hemos tenido mejor√≠a estamos esperando  nuestra ubicaci√≥n es barrio de el Carmen sur  calle 74 valencia estado carabobo,28330,38213,68410,134953
1346,Denunciaron que toneladas de comida se da√±aron en galp√≥n del Clap en T√°chira (Im√°genes) https://t.co/1l7q2qOGQ0,46655,30716,1853,79224
1347,#SUCESOS Hallan cuerpo calcinado cerca de la finca de Alex Cabrera https://t.co/Q18A62vpv6 cabrera/,94194,63715,85877,243786
1348,"#13Abr || El pueblo con valentia, dignidad y amor por la Patria, retoma el hilo constitucional que los traidores hab√≠an violentado y devuelve el poder al Cmdte Supremo Hugo Ch√°vez. ¬°Que viva por siempre la uni√≥n c√≠vico-militar!
#YoSoyFANB
#VictoriaPopularRebelde
#GNBFalc√≥n https://t.co/6sPhDsWOnI",21645,35507,23344,80496
1349,"@luis_villegasr @EneidaLayaPsuv @nicmaduroguerra @delcyrodriguezv @ASIST_SENIAT @Mippcivzla @Jateranoficial @JuventudPSUV @VTVcanal8 @RanderPena @BCV_ORG_VE @ViceVenezuela Envien la sundeen a maracaibo,parroquia juana de avila,urb sana jacinto un pan que el jueves costaba Bs 205.000 el Viernes con la Reconversion lo llevaron a Bd de 300",52942,3660,29518,86120
1350,"#Adolescente #Desaparecido #Ecuador #Guayaquil #Colombia   
El Consulado del Ecuador en Ipiales gestion√≥ el retorno hacia el Ecuador de un menor de edad que se encontraba reportado como desaparecido desde el pasado 11 de agosto. ‚û°Ô∏è‚û°Ô∏è https://t.co/1PHerVvliF https://t.co/uhHJmyBERc",71864,54862,51075,177801
1351,"@jousebiod @luis_villegasr @Mippcivzla @BCV_ORG_VE @delcyrodriguezv @nicmaduroguerra @ASIST_SENIAT @JuventudPSUV @EneidaLayaPsuv @almacaracas @VTVcanal8 @UNoticias @RanderPena Mira mana, una foquita.",94634,39259,14543,148436
1352,#REGIONALES Saboteo en tuber√≠a de 16‚Äù afect√≥ suministro hacia la parte alta de La Vela alta https://t.co/ih25beXkdn,46570,99682,95498,241750
1353,Yo amo las fotos en todo su esplendor.üìçPARAGUAN√Å- VZLAüåµüåû https://t.co/gCzc5XFdzu,2041,69638,36653,108332
1354,Punto fijo estado Falc√≥n en los hospitales m√°s es lo q no atiende q lo atiende si voy  infartado   te muere no te quieren   atenden los ni√±os tampoco un llamando a las autoridades competentes sea m√°s humano eficientes no ineligente . Presidente ojo por favor ....,3716,59710,63545,126971
1355,Qu√© su domingo sea reparador. Nosotros continuamos trabajando sin descanso por su bienestar. .@GNB_tachira .@GNBCmdtGral .@GBcmdte21gnb @GnbGaranteDePaz.. https://t.co/7JKdn1ohGR,33822,35363,16106,85291
1356,As√≠ no se puede ganar con los √°rbitros en contra @Carabobo_FC,17389,11614,49769,78772
1357,Juramentan Comando de Campa√±a Arist√≥bulo Izt√∫riz en Carabobo https://t.co/HS6TlMrMIX https://t.co/Jd8OyPUdjf,31787,14911,16032,62730
1358,"Proyecto de Salud Visual en el Estado Carabobo,,brindando un servicio de excelencia al Pueblo Venezolano. 
#ACubaPonleCorazon 
#HeroesDeLaSalud https://t.co/TRQvo5RyyT",68985,48171,78924,196080
1359,"#Importante 
A las 11:35:55 se registr√≥ un #sismo M1.4 localizado 2 km al S de Coyoac√°n, CDMX (Col. Pedregal de Santo Domingo). 
No se report√≥ percepci√≥n.
#InfoSismosMx",72448,78534,42038,193020
1360,#REGIONALES ZODI vigilar√° el comportamiento del transporte p√∫blico y comercios durante la Cuarentena en Falc√≥n https://t.co/0By7xrMU2J,42369,58967,72537,173873
1361,"BCV hace intervenci√≥n cambiaria este lunes: d√≥lar paralelo arranca semana en alza a Bs.4,33 https://t.co/dTz0yPKHly\'",43756,89357,66612,199725
1362,"Escultura en Cristal ""ECLIPSES"" de Jan Zoritchak
Obra en cristal Daum France realizada en 1.974, medidas: 19 x 19 x 6 cm. No 45/300
US$ 5.500,oo
58.414.4105590 en Valencia Norte Edo Carabobo Venezuela https://t.co/H1EQwKsqHX",7476,71825,26300,105601
1363,"Esos mismos que entregaron a las FARC y carteles de droga (nacionales e internacionales) los estados ZULIA, Tachira, Apure, Barinas, Bol√≠var, Amazonas, Monagas, Sucre, Delta Amacuro, hablan de ""ratificaci√≥n y defensa del Esequibo"" CORTINAS DE HUMO MIENTRAS DESPEDAZAN AL PA√çS!",4775,742,52765,58282
1364,"#SUCESOS | Habitantes de El Callao, estado Bol√≠var, encontraron  dos cabezas humanas dentro de un bolso color azul en la Plaza El Jobo. 

https://t.co/Ui4rmbLdgw",26982,679,87309,114970
1365,".@FreddyBernal Mi gente de #T√°chira, los invito ma√±ana Viernes #20Ago a partir de las 10:00 am a sintonizar #ReporteBernal, transmitido por YVKE T√°chira, dial 94.5 FM, junto al Afrodescendiente de la Comunicaci√≥n @arguelloyepfri.
#SoyComunicadorClap
#AmemosAlTachira https://t.co/CrqNXcTAhY",17829,97746,52838,168413
1366,PASEO CABRIALES EN CARABOBO basura en orillas del puente malesa  indigentes malandritos Descubrieron una org√≠a bajo un puente al escuchar extra√±os gritos y llamar a la polic√≠a https://t.co/eTLbD7Mwyw #noticias #carabobo #venezuela https://t.co/jxUpDTbRAm,56381,68773,92251,217405
1367,"Felicidades a todos los ciclistas en nuestro d√≠a en Judibana, Falcon, Venezuela https://t.co/ukAeDDm5wg",46731,68663,93982,209376
1368,"yo hice todos los pasos y al generar la apertura me sale error, que puedo hacer?",44918,30117,14809,89844
1369,"#23Oct | @JAVIERBERTUCCI: La zona industrial de Carabobo est√° funcionando al 15%. Los empresarios carabobe√±os piden, como exigencia √∫nica, un cambio de gobierno regional para llevarla del 15 al 45 por ciento en el primer a√±o.",7061,31875,77759,116695
1370,"T√°chira, Michelena,  cuna del General Marcos Evangelista P√©rez Jim√©nez https://t.co/ikMTkFHAtb",42104,24393,81960,148457
1371,"#10Sep Vuelve el caos al estado T√°chira ante la escasez de combustible, donde la gasolina colombiana comienza a apoderarse del mercado negro. Las pocas estaciones habilitadas han generado filas de hasta m√°s de mil veh√≠culos. Reporta  @luzdarydepablos para #TVV https://t.co/Pu7TG8ISBB",23985,8990,91274,124249
1372,"La Alcaldesa @SumireFerrara se unen al duelo que embarga a la Familia Antique Pereira por el triste Fallecimiento de ""Wenceslaa del Carmen Antique Falc√≥n"" madre del Gobernador del Estado Lara Alfredo Pereira

             ¬°Paz A Su Alma!

@RMarcoTorres
@GobiernoAragua_ https://t.co/Re5aJZFGo7",2582,75851,13850,92283
1373,"@Cubacooperabol2 Estado Bolivar CDI Castillito. Celebrando el 61 
Aniversario de la creaci√≥n de los CDR.#Aniversario61CDR #CubaPorLaVida 
#CDRCuba #SomosDelBarrio #ACubaPonleCoraz√≥n @cubacooperavenMINSAPCuba @unidad_central @AdanVillavicen5 @CastillitoCdi @Cubacooperabol2 https://t.co/oG6RwCRohq",67209,74748,37524,179481
1374,"@Toro_rojo1 Preguntarte si est√°s dormido o despierto, mirar el reloj y luego a un punto fijo, volver a mirar el reloj y el punto fijo, ya que en la ‚Äúrealidad‚Äù la hora no cambia r√°pidamente y en un sue√±o s√≠.
Cuando sue√±as puedes hacer los mismos ejercicios y te dar√°s cuenta de que es un sue√±o",80318,9411,57560,147289
1375,"La #GNBFalc√≥n, prestan Seguridad a las instalaciones de las plantas El√©ctricas en todo el territorio Falconiano #31Mar #FANB
#TodosContraElVirus
#GNByPuebloAlerta
#FANBEnDefensaDeLaDignidad .@NicolasMaduro .@cmdtegralgnb .@GNBGDjuvenal .@LopezvargasR https://t.co/CexTlbhUuF",56620,5753,35290,97663
1376,"Efectivos del .@destacamento134 se mantiene en #LuchaContraLaCovid19 con puntos de control m√≥vil. #12Abr #FANB #GNB
#GNByPuebloALaVanguardia
#PuebloComunicadorRebelde
.@NicolasMaduro 
.@cmdtegralgnb
.@GNBGDjuvenal
.@LopezvargasR #GNBFalc√≥n https://t.co/hgkqzvJWkm",1924,62413,15301,79638
1377,@NicmerEvans Un dato: en la antigua texaco de las Mercedes hoy ech√© al cambio BCV en Bs.,42122,42704,68202,153028
1378,Mujer que tosi√≥ en la cara de otra fue condenada a prisi√≥n https://t.co/dewIMbroSj,32359,34939,73100,140398
1379,@BcodeVenezuela @BCV_ORG_VE Pobre Bol√≠var. Qu√© te hicieron? üòî,88606,91671,6189,186466
1380,"@News1Lead @Falcon_Swap @Bitcashpay1 That really a good news getting bigger better version of it surely great event and platform wait for us by benefits including privacy, lower gas fees and aggregation. Good luck for more upcoming events",55423,72369,17561,145353
1381,@Lester56077380 @_croquetisha_ Lester c√°llate que t√∫ eras punto fijo en el comedorüòÇüòÇü§£,65202,40240,94861,200303
1382,"Le resta solo un juego a cada uno en esta 3 ronda. 

Ma√±ana 
Zamora Vs T√°chira 

La otra semana 
Zamora Vs Estudiantes 
Portuguesa Vs Zulia",45470,365,45426,91261
1383,"Visita de intercambio de la Oficina de Atenci√≥n a las Misiones Sociales Cubanas en Venezuela en el Estado #tachira CDI Sim√≥n Bol√≠var  
#CubaCoopera https://t.co/7OOpDbEj0A",41685,1394,16970,60049
1384,"üáªüá™ Patriotas del #GNBBarinas garantizando el resguardo las 24 Horas la seguridad del pueblo del mcpio Barinas.
#25Sep  #CEOFANB
#LasSancionesSonUnCrimen
#CentinelasGarantesDePaz
#GNBD332Barinas
.@PresidencialVen
.@PrensaCmdteGral
.@GNBCmdtGral
.@NicolasMaduro https://t.co/TvodP0aTOb",83436,31346,13649,128431
1385,@EneidaLayaPsuv @MinEcoFinanzas @delcyrodriguezv @ViceVenezuela @BCV_ORG_VE @SudebanInforma @Mippcivzla @VTVcanal8 @RNVinformativa @avnve @TVFANB @laradiodelsur presidente debe urgentemente hacer un reunio con el empresariado afinar precios y congelarlos por un tiempo . no le tenga miedo que lo que paso hace dos a√±os atras no vuelve a pasar,94820,93568,15989,204377
1386,"PERO ES QUE NO SALE NI AGUA DE LAS TUBERIAS!
NO HE VISTO A NING√öN CANDIDATO PRONUNCIARSE AL RESPECTO, ANDAN VUELTOS LOCOS POR EL ESTADO BOL√çVAR PERO NO VEO QUE DIGAN NADA POR TODO LO QUE EST√Å PASANDO. https://t.co/6NF4v5apS2",19553,62840,30295,112688
1387,@BcodeVenezuela Eso ser√° donde porque aqu√≠ en el estado Barinas ninguno funciona,57744,92340,61103,211187
1388,"V√≠a @NestorLReverol 

Como parte del despliegue del @mppeevzla por el estado Bol√≠var, visitamos la Central Hidroel√©ctrica Sim√≥n Bol√≠var, en Guri, donde supervisamos las labores de mantenimiento realizadas por nuestra fuerza trabajadora del √°rea de Generaci√≥n. https://t.co/ZvKBOCsVvJ",13456,36442,11721,61619
1389,"@antonio28004366 GUACA. ""LA ISLA DEL TESORO"" EN VENEZUELA. PEN√çNSULA DE PARAGUANA ESTADO FALC√ìN. Sus habitantes todos pescadores hallaron muchas joyas y  piezas de oro un d√≠a en la playa. PARAGUANA fue el lugar donde Crist√≥bal Col√≥n crey√≥ ""haber llegado al 
Paraiso. As√≠ es VENEZUELA. https://t.co/eVqez3uwct",49438,14445,29329,93212
1390,"Valientes del CDI Sim√≥n Bol√≠var, municipio Casacoima, estado Delta Amacuro salvan vidas en los m√°s rec√≥nditos lugares. Celebrando 61 a√±os de los Comit√© de Defensa de la Revoluci√≥n. #Aniversario61CDR https://t.co/KZSLM10bvq",48303,41182,57103,146588
1391,"LARA Y CARABOBO GANAN EN REGIONAL DE BALONCESTO U14

Los equipos de Lara, en femenino y masculino, y Carabobo en masculino, ganaron sus compromisos en la jornada de este mi√©rcoles en el gimnasio Teodoro Gubaira.
Lara venci√≥ en femenino a Aragua 54-52. https://t.co/U8shv9xDV7",96453,85524,55418,237395
1392,"Azocar Ojo e' Pescao Palangrista y Corrupto Cobraba y estafaba a la Loteria del Tachira con sus propagandas que No publicaba,,, Averig√ºen su pasado delictivo en el T√°chira para venir a hablar paja del Gobierno Revolucionario!! https://t.co/KHxXL18FNV",72243,89861,92966,255070
1393,"Protecci√≥n y bienestar para el pueblo de #Barinas

¬°Juntos para una #BarinasSegura!

#25Sep  #CEOFANB
#LasSancionesSonUnCrimen
#CentinelasGarantesDePaz
.@NicolasMaduro
.@PresidencialVen
.@PrensaCmdteGral
.@GNBCmdtGral https://t.co/mFsXlcmT6S",75796,18471,69937,164204
1394,"Reportan fallo del servicio el√©ctrico en:

Caracas, Aragua, Vargas, Carabobo, T√°chira, Lara, Falc√≥n, Apure, Monagas, Zulia, Gu√°rico, Nueva Esparta y M√©rida.

El baj√≥n se produjo desde horas de la tarde de este domingo 12 de septiembre.",36550,62411,8452,107413
1395,@Banesco Caido no abre ni su pagina principal.,36077,13664,34838,84579
1396,"Daniel_RiosVE: Aborto, armas, religi√≥n: los casos clave en la agenda de la Corte Suprema https://t.co/ii7aeHmQaJ #DanielRiosTeInforma #Carabobo",85731,42111,99470,227312
1397,"D√≠a y noche, Centinelas de la #GNBFalc√≥n se mantienen comprometidos en garantizar el Bienestar de nuestro pueblo. 
#3Abr #FANB
#SputnikVGarantizaVida
#GNBGaranteDePaz 
#FANBEnDefensaDeLaDignidad
.@NicolasMaduro 
.@cmdtegralgnb
.@LopezvargasR
.@GNBGDjuvenal https://t.co/0wHtw0MblW",97224,30800,10728,138752
1398,https://t.co/fcIUXloC4o,98727,37925,78245,214897
1399,Sin luz en Carabobo NAGUNAGUA üôÑ Pero Claro  Para los pendejos los ricos Tienen Luz cada vez qu√© veo un discurso de Nicol√°s Me decepci√≥no m√°s...,91290,31296,47353,169939
1400,"¬°RENDIDOS A SUS PIES!üëÄ‚òùüèª

Ojo a las palabras que le dedic√≥ el @AraguaFC a Alfredo Stephens luego de que hoy marcara en la victoria (2-1) sobre Carabobo.

#AgendaF√∫tbol https://t.co/Tuym9zYfE3",5315,61460,37911,104686
1401,Digo y lo mantengo en punto fijo no hay parejas sw solo curiosos del tema y no concretan nada,62149,22865,92763,177777
1402,"FocoInformativo ||  Econom√≠a‚û°   BCV coloca este 4-O un total de $ 50 millones en el mercado cambiario 
#4Octubre #BCV #dolarvenezuela #MercadoCambiario #Venezuela 
https://t.co/cGPspA8sxy",68500,33420,14966,116886
1403,"H√°gase la luz del d√≠a y de la electricidad... Despu√©s de una noche de lluvia. As√≠ est√° el cielo desde Carabobo, San Joaqu√≠n. Saludos @Meteovargas https://t.co/fA5IyrJICU",95616,15190,4455,115261
1404,"@TuMundoInter Ustedes me pueden dar respuesta de mi Solicitud de Reclamo. Servicio de Internet #409613. Nadie me da respuesta. Ni los operadores, ni servicio t√©cnico. Y el personal t√©cnico de Punto Fijo me dicen que ni manejan informaci√≥n",95939,22439,10599,128977
1405,Que hay de la denuncia del cajero q le estaba quitando dinero a una se√±ora por darle efectivo en la guaira???...y q la gerente no hizo nada...,3958,8193,98593,110744
1406,Capturaron a sospechosos de tr√°fico infantil en Carabobo https://t.co/Mjvd5AiqmK,24208,88609,87311,200128
1407,Tres detenidos por robos y dos solicitados reporta Cicpc en Falc√≥n . https://t.co/2s5wfgvRJu #sucesos,8612,64740,74108,147460
1408,@Jose98308760 Al 3 b del pedregal,58347,62820,21418,142585
1409,"#Sucesos | Muere hombre mientras hac√≠a la cola de gasolina en Carabobo
https://t.co/oxzBlLx5j6",59093,64121,47605,170819
1410,@RunRunesWeb la gente no va a querer pagar dolares en los negocios prefieren venderlos para pagar en bolivares porque ay diferencia entre el BCV y el negro,79207,22312,14400,115919
1411,As√≠ iniciamos el d√≠a de Hoy en Escuelas Abiertas Agosto Bicentenario desde Capacho Tierra de Hombres y Mujeres amantes de la PAZ.... Venceremos @charlychaves @Crazet2011 @yelitzePSUV_ @supervisionZET1 @ZonaEducTachira @PSUVTachira @Tachira_Jpsuv @FeveemTachira https://t.co/4RnAP5OjQG,15216,18689,38309,72214
1412,"""EL HOMBRE NUEVO"" :
ESTE LADR√ìN #CHAVISTA ADMITE que se rob√≥ esta bomba de gasolina y se la quit√≥ a un privado. Ahora como cliente se ARRECHA porque no le quieren lle ar el tanque full, sino los 20 litros que le corresponden. #T√°chira #26Ago
#Venezuela https://t.co/s6vbKmd98q",90631,95,54367,145093
1413,"Carabobo: Seis personas detenidas por trata de mujeres, ni√±as y adolescentes https://t.co/gRLjaMByXv",6774,76858,27645,111277
1414,HOY 29 AGOSTO ACOMPA√ëAMOS EN EL CNE AL FUTURO GOBERNADOR DEL TACHIRA .@FreddyBernal Y A TODOS LOS CANDIDATOS DE LA PATRIA EN SU INSCRIPCI√ìN RUMBO A LA VICTORIA DEL 21NOV #SoyComunicadorClap @arguelloyepfri @Juntosxtachira1 @PSUVTachira @BermudezJoseA @dcabellor #AmemosAlTachira https://t.co/UXybM70upN,39702,42436,54323,136461
1415,"Ahorita estuviera yo por all√° en Chichiriviche o Tucacas en la posada tom√°ndome una snaifor, hp covid te odio",13564,64838,74954,153356
1416,"@MIJ400 yo acabo de pagar unas empanadas a 5.3 y porque ya me las comi, pero de pana antes de entrar al negocio pregunto.

Hay muchos locales aceptando el d√≥lar a precio de BCV, as√≠ que no entiendo por que exageran",46980,58166,47665,152811
1417,@AntiProgreWorld Se est√°n destapando todas las marramucias en todos los niveles !! Ac√° voy a esperar a que la justicia alcance a Rangel G√≥mez y su familia para que respondan por todo lo robado en el estado Bol√≠var.üçø,37911,36520,59233,133664
1418,@rmfinanzas Seguir√© difundiendo esto por las redes hasta que me den respuesta. Al menos esperaba que me garantizaran mi TDD para el lote pr√≥ximo. Los indolentes me indicaron que tengo intentar suerte nuevamente en la web. üò°ü§¨ @NicolasMaduro @BcodeVenezuela @Sundecop @sundde_ve https://t.co/lntz2ts9QT https://t.co/mjQlsUb19T,31285,94172,76884,202341
1419,@jguaido @VTsepkalo Y pronto tendr√°s un encuentro con la fiscal√≠a y los reclusos de la c√°rcel Carabobo‚Ä¶,33159,14397,85660,133216
1420,Ayer di un recorrido por varios comercios y si es verdad todos tiene la tasa de BCV (4.18)en un papel en cada negocio pero el detalle es que cuando vas a pagar te cobran a (4.5) es decir a la tasa de d√≥lar que ellos le da la gana a los fiscales no se queden con el papel.,72352,63594,96354,232300
1421,#NACIONALES Se paraliza la refiner√≠a Card√≥n por baja producci√≥n de nafta https://t.co/lHsByXsTdB,43057,59885,61072,164014
1422,"@NicolasMaduro @GobVictorClark @NestorLReverol @CorpoelecInfo @HildemaroLeal @elsolidariogv @ColinaDepool sin servicio el√©ctrico por m√°s de de 3 horas sector 19 de abril de Ali Primera I, Mcpio Los Taques, Pquia Judibana Edo Falcon, llego el agua y no podemos encender las bombas",10204,62228,45267,117699
1423,@ReporteYa P√©rdida en tiempo y espacio en el Hospital Adolfo Prince Lara de Puerto Cabello estado Carabobo mueren a diario m√°s de10 personas por covid19 el Hospital ya esta colapsado,74130,49840,59396,183366
1424,"Falso que regresara la plataforma el lunes... Pero si, la pondran el lunes kajsjakajaj",13813,38022,73525,125360
1425,"#03Sep|| Efectivos del @CapachoPac, #T√°chira, practicaron la aprehensi√≥n de un ciudadano, a quien le incautaron 80Lts. de combustible, por presunto contrabando de combustible. Retenci√≥n de 01 moto.

#VamosAVacunarnos https://t.co/lfM664oVaY",21923,7936,38050,67909
1426,"Para las amantes de las plataformas üëå

#Flexi #PiedrasNegras #primaveraverano2021 https://t.co/wNgwW6i1Ln",26335,38439,8989,73763
1427,Buenas tarde que informacion reciente tienen con respecto a legalizar titilo de bachiller en la zona educativa de carabobo. Ingreso a la pag para tomar cita y no me permite el ingreso. Gracias @mccoam @Wood728,61764,95188,65117,222069
1428,"Por el bienestar y progreso de ambos pueblos, Norte d Santander yel Tachira construyen paz, seguridady prosperidad. Excelente encuentro entre representantes  para generar confianza y esperanza
#UnidadPorLaPatria
#SoyComunicadorClap 
.@NicolasMaduro 
@arguelloyepfri 
@soyangeladi https://t.co/dUODwzjcc2",59429,34996,17081,111506
1429,"#Hoy #28Mar por instrucci√≥n de nuestro Min. @Alipadron6, el Vice. Ô∏ède Turismo Nacional @JessPlasencia4  se despleg√≥ en el estado #Falc√≥n, en la actividad de Otorgamiento de Certificado de Categorizaci√≥n a varios prestadores. https://t.co/CTS20QpnUs
#Cuid√©monosEnFamilia https://t.co/dQUT4h35pP",61859,36549,18060,116468
1430,"Necesitamos resuelvan el problema del agua en Carabobo, ciudad alianza cada rato sin agua #CaraboboSinAgua",38153,59123,66233,163509
1431,@ZonaFUTVE @Carabobo_FC Excelente programa. Saludos desde Naguanagua #ZonaFUTVE ‚öΩÔ∏è,97076,40244,66099,203419
1432,"#ChampionsLeague ‚öΩ #GrupoE #J1 | 11 teut√≥n | | #FCBarcelona üÜö #BayernMunich |

#Tachira #Venezuela https://t.co/yuBy4CsBkV",28085,81594,99033,208712
1433,#23Oct  ¬°Aqu√≠ Nadie se Rinde! üí™üèΩüí™üèΩü¶áü¶áüáªüá™üáªüá™ #BatallaPorLaPaz #carabobo #lacava #docentes #sabado https://t.co/d0Hkaxp2UB,86325,31653,82846,200824
1434,"@therainbowwhale Yo soy un adulto de 45 a√±os, vivo en Carabobo, Ing de Sistemas con solo habilidades administrativas y Gestion de Servicios, desempleado mas de un a√±o ya.
Realmente, lo √∫nico que quiero es trabajar y ganar lo suficiente para sustentarme y ayudar a mi Familia",62125,39212,39868,141205
1435,"#8Sep #NoticiasyPunto | @LuzfrandyC: Aumenta desenfrenadamente la presencia de vendedores informales en el estado T√°chira  

Conoce detalles en https://t.co/b0oZ9KdXyK 
https://t.co/3XXh3vQeqI",85349,60317,18677,164343
1436,#NACIONALES Aumentan a m√°s del 50% la ocupaci√≥n de camas UCI por pacientes con Covid-19 en Venezuela https://t.co/Ni9su7XDDF,1637,5019,33629,40285
1437,"""Los problemas est√°n a la vista de todos pero tenemos grandes bondades como el Salto √Ångel, el Roraima, r√≠o Orinoco y Caron√≠,¬† el parque La Llovizna , el Casco Hist√≥rico. Es un estado con una potencialidad grande, tenemos todas las bondades para fortalecer el turismo"". #Bol√≠var",53008,82461,29158,164627
1438,"Guardia del Pueblo T√°chira en el ""Plan amor en acci√≥n"" a las victimas del bloqueo economico en el sector de Campo Alegre Municipio San Crist√≥bal, llevando felicidad a mas de 240 familias en compa√±ia de la Diputada Olga Diaz. https://t.co/9SRTzwTUGm",5949,61476,47898,115323
1439,"Durante rescate de un comerciante, murieron tres delincuentes en Carabobo | #13Oct #Carabobo 

https://t.co/EYjFEA7X8w",2570,93035,14406,110011
1440,"Centinelas del .@GNB41_CARABOBO, realizar√≥n la aprehensi√≥n de un (01) Cddno solicitado, A/O del @MinpublicoVE #GNBCaraboboSeguro #GNB2daD412Carabobo #13Oct  PuebloPatriota
#Mon√≥merosEsDeVenezuela
UnidosPuebloyGNBEsSoberan√≠a
.@libertad003
.@GnbGaranteDePaz https://t.co/KfmTNYbohu",87720,45981,59266,192967
1441,En la calle Bolivar del Tigrito Estado Anzoategui las autoridades indolentes creen que somos camellos ya que tenemos m√°s de un mes sin agua. Por favor se les agradece tomar cartas en el asunto ya que hay ni√±os y ancianos que est√°n pasando penurias Auxilio queremos agua,68036,96672,51432,216140
1442,"@antoniojbarrad1 Cuantos alacranes comi√≥ este payaso... esto es lo que ofrece Carabobo? que pena, penita mi Venezuela.",78777,53643,25507,157927
1443,"Cdi panamericano tachira
#MMedicaCubanaTachira 
#HeroesDeLaSalud 
#ACubaPonleCorazon 
#CubaPorLaVida 
@CDIPanamerican1 https://t.co/6hVGwHnA6t",12706,26108,55697,94511
1444,"La Corte y la Procuraduria saben que lo que hizo Bol√≠var fue por salvar vidas, sin embargo, con todo lo que aport√≥, el estado asesin√≥ a varios j√≥venes en las protestas, clara violacion a derechos humanos del estado corrupto!! https://t.co/kS35pYz2SR",5808,73253,20671,99732
1445,"Promueve Norma Trevi√±o eje ‚ÄúPiedras Negras Econ√≥mico, Emprendedor y Tur√≠stico‚Äù
https://t.co/fnErQ6y6pn
#PiedrasNegras #Pol√≠tica https://t.co/I2MmEyOzId",12583,51093,32379,96055
1446,@banesco no logro  accesar a la banca online des ayer 28 .....alguien tendr√° informacion al respecto? por favor,82548,96531,2294,181373
1447,"¬°Arrestado! Poderoso narco falconiano relacionado con c√∫pula de Maduro
   
https://t.co/SDNu151eIW",74640,91331,81456,247427
1448,"En funci√≥n de Justicia Social, el .@GNB_VCostera efectu√≥ donaci√≥n de 30 mil Lts de agua potable en el Edo. Falc√≥n.

#18Abr #FANB #GNB #GNBCVC
#PrevenirSalvaVidas
#GNByPuebloProtegido
.@NicolasMaduro 
.@cmdtegralgnb
.@GNBGDjuvenal
.@LopezvargasR
https://t.co/Ozvx6BTtbs",31581,60045,77488,169114
1449,"@BcodeVenezuela Me falta dinero en mi cuenta , ten√≠a 570 y me sale que tengo 443 y no hay ninguna nota de d√©bito que me explique el por qu√© de esta situaci√≥n, necesito repuestas https://t.co/Ue923w83WN",55111,66295,12246,133652
1450,"#5Abr Han usado el papel medi√°tico para distorsionar la verdad. Dando se√±ales que la #FANB estaba acabando con el pueblo de La Victoria. Todo se trata de una mentira.
.@vladimirpadrino #GNB
#RadicalesContraLaCovid19
#FANBEsSoberania
#GNByPuebloEnVictoria 
 #GNBFalc√≥n https://t.co/U8yuJU9EaQ",85042,62049,96519,243610
1451,"La #GNBFalc√≥n  Seguimos en Batalla Victoriosa Comprometidos en garantizar la Paz y Bienestar del Pueblo Venezolano.
#29Mar
#Cu√≠dateDeLaCovid19
#GNBAlertaJuntoAlPueblo
#FANBEnDefensaDeLaDignidad 
.@NicolasMaduro 
.@cmdtegralgnb
.@GNBGDjuvenal
.@LopezvargasR https://t.co/z7KUGIE07B",49529,65917,80078,195524
1452,"‚õîPORTE IL√çCITO || Centinelas del  @GNB41_CARABOBO efectuar√≥n la aprehensi√≥n de un cddano a qui√©n se le incaut√≥ un arma de fabricaci√≥n rudimentaria A/O del .@MinpublicoVE #GNBCaraboboSeguro #GNBD411Carabobo  #14Oct  #PuebloyCEOFANBEsPaz
#Soberan√≠aPatriayPaz
CentinelasPorLaPatria https://t.co/J6xyrUGYso",1838,64565,67891,134294
1453,@LucyPN una bolsa de pan canilla de 5 und. Churuguara edo. Falc√≥n,10849,32873,63725,107447
1454,"En las √∫ltimas dos semanas el BCV vendi√≥ d√≥lares a un precio superior al mercado, lo cual le dificult√≥ a la banca vender las divisas a sus clientes.",75377,20171,42589,138137
1455,Ver este video de Instagram de @juntosxtachira https://t.co/3FFyQWi6MJ,19683,23888,13163,56734
1456,@TomasBastante @mercadosyaccion hoy como empresario veo muchas personas calladitas despues que deje claro que todos los venezolanos debemos apoyar la tasa bcv y olvidarnos de tanto mejurgue especulativo hoy un silencio sepulcral para lo que insultaron hacer lo correcto no es necesariamente lo que es conveniene.,80333,41326,9329,130988
1457,@QueGuaro Lo lamentable que muchas veces el BCV lo tiene m√°s alto que el promedio,87341,51340,99860,238541
1458,@PbSabry Pero porsupuestamente y mirando a un punto fijo con cara de ignoto!,90573,19610,21161,131344
1459,"üáªüá™ La #FANB prepara despliegue en todo el espacio geogr√°fico y aeroespacial de la Naci√≥n, para los Ejercicios Militares de Acci√≥n Conjunta Integral y Unificada Escudo Bolivariano ""Bicentenario de Carabobo 2021"".

#BatallaPorLaPaz
#REDIORInvencible
@libertad003
@dhernandezlarez https://t.co/zbdwtgjkzP",12207,36815,48191,97213
1460,"Comenzar√°n a analizar protocolos de regreso a clases en #PiedrasNegras; Jurisdicci√≥n indic√≥ que tienen la instrucci√≥n de hacer algunas intervenciones y difundirlas
https://t.co/ZqsJsOsmb5",11542,19410,3979,34931
1461,"La familia del preso pol√≠tico Francisco Pacheco vive en Carabobo y el est√° recluido en Ramo Verde, estado Miranda, a 2 horas y media en carretera. Su familia es de muy escasos recursos, sus hijos no lo han visto desde diciembre de 2020. 
#LiberenAPacheco",68241,61849,26959,157049
1462,"Gracias BCV lo lograste, ahora espero que los comerciantes tambi√©n hagan lo mismo en el nombre de Dios. Tienen que venir tiempos mejores para nuestra patria y para nosotros el pueblo. Un buen inicio de semana para los twitteros revolucionarios. Nosotros Venceremos!!! https://t.co/sR9pmewsZU",84877,42134,95770,222781
1463,@BcodeVenezuela Cuando me van a devolver mi pl√°tica por Dios?,11216,70522,52097,133835
1464,"@venezuela_migra @NASA_es Una isla? Me toca leer, investigar. Saludos a los paisanos paraguaneros desde San Luis, Sierra de Coro. Saludoote!!!",16089,70251,71994,158334
1465,"Con la alegr√≠a y entusiasmo caracter√≠stico de los revolucionarios, el d√≠a de ayer acompa√±amos al Protector y Candidato a la Gobernaci√≥n del #Tachira @FreddyBernal y a los 29 candidatos de la Patria de las Alcald√≠as de nuestro estado a la Inscripci√≥n ofic‚Ä¶ https://t.co/43x60efCIl",89819,14174,99394,203387
1466,@ElPitazoTV : #Tecnolog√≠a | Aqu√≠ te damos detalles sobre los otros beneficios que tendr√°s al afiliarte a Multipagos Banesco: https://t.co/vshpMGKzxp https://t.co/59GdjZEpep,96169,84320,68016,248505
1467,"@BcodeVenezuela @rmfinanzas Buen d√≠a quiero que por favor me informen, me acaban de tranferir un pago m√≥vil y me descontaron dinero que est√° pasando ya me robaron demasiado para seguir quit√°ndome plata y entonces? @Bcodevenezuela",75137,7656,9939,92732
1468,@ReporteYa @churuguara De verdad que cagada,62395,74488,30401,167284
1469,"#Raftingüõ∂ En #Barinas encontraras no solo la mejor #aventura, sino tambi√©n los mejores #r√≠os de #Venezuela para el disfrute y la pr√°ctica de #deportes en aguas bravas.

M√°s informaci√≥n por colibritours@gmail.com ‚úâÔ∏è

 #Turismo #Tour #Barquisimeto #Valencia #Tachira #Valera #Zulia https://t.co/b6mqddc8PS",77421,51937,88939,218297
1470,"La gente de la CANTV, pese a los sabotajes, la falta de recursos y el bloqueo tecnol√≥gico, haciendo mantenimiento al sistema de telefon√≠a e internet en la avenida 190 de Naguanagua, Carabobo @servicios_416 https://t.co/GXxGGL2h8s https://t.co/fbF9UBGkhQ",6208,12120,91269,109597
1471,90+3': We are three minutes into the six added on. Rojas has just stifled a late Estudiantes attack with a strong claim. These past ten minutes have been all-action in a game that hasn't always been full of momentum. Tachira will be delighted with Estudiantes dropping points. 0-0,3805,90855,51619,146279
1472,"Casas del Pedregal  |   Luis Barragan
https://t.co/UAmxQkSCv7
#CATIBERIC ARCH_20210327üêæüçÅ https://t.co/qY9s4i1MZW",8821,80875,26968,116664
1473,Casa del Padre üçÉüå≤#T√°chira https://t.co/Hg66WN2T6P,43271,71858,71420,186549
1474,"#DeInter√©s üìÉ #GNB y @sundde_ve supervisan comercios en el estado Bol√≠var

Noticia ‚û°Ô∏èhttps://t.co/8SS7ozRPJR

#6Oct CEOFANBPorLaPatria
#Producci√≥nEnMarcha
#GNBBol√≠var
#GNBD621Bolivar
 PuebloyFANBInvencibles
.@vladimirpadrino
.@GNBCmdtGral
https://t.co/lNGGEa4jGj",29388,27465,80301,137154
1475,"#31Mar el .@GNB_Amazonas
Realiz√≥ reuni√≥n de trabajo con el gremio de transporte, en busca del bienestar del pueblo.
#FANB #GNB
#TodosContraElVirus
#GNByPuebloAlerta
#FANBEnDefensaDeLaDignidad 
.@NicolasMaduro 
.@cmdtegralgnb
.@GNBGDjuvenal
.@LopezvargasR #GNBFalc√≥n https://t.co/aEO6mafvYa",51372,97964,57060,206396
1476,"@DIRECTVGO @giraltpablo @LaLiga @fpetrocelli Buenas tardes... gran transmisi√≥n... saludos desde Pedregal, Falcon Venezuela. Gana el Bar√ßa, messi marca por partida doble...",25771,11531,88158,125460
1477,"En serio, 5 d√≠as, no han podido resolver en 5 d√≠as, hasta cu√°ndo est√° verga, necesito mi dinero, si esto lo hubiera hecho Banesco o Provincial ya estar√≠a presa toda la directiva, el banco estuviera intervenido y hasta expropiado...!Cuando, co√±o cuando‚Ä¶ Ver m√°s",98085,29931,42444,170460
1478,"@luisromeroc El detalle es por ejemplo el tachira, la actual gobernadora se presento sola a las primarias, como que tiene muchas mas Bo??? Que algunos otros.",58164,53966,76303,188433
1479,"#ReporteBT | Conoce el valor de las Mesas de Cambio del d√≠a de hoy #20Oct 

@EneidaLayaPsuv
@BCV_ORG_VE https://t.co/PMBtld6imK",89547,34594,5637,129778
1480,"@la_patilla y de que extra√±arse si la estaci√≥n parque Carabobo est√°n todos los vendedores del metro comen, orinan y hacen su plan de trabajo y all√≠ no hay nadien que los saque no hay personal del metro ni polic√≠as",8626,37164,17485,63275
1481,"Que buen gesto y compromiso real por el #Tachira @wiliamendezg pero debemos estar atentos,c√≥mo se dice en el f√∫tbol hay jugadas sucias. @elgochoceballos https://t.co/LT0uWro76F",16541,2406,183,19130
1482,"Vendo equipos nuevos especiales ya adaptados a la economia venezolana para cualquier enchufado que quiera invertir pr√≥ximamente en los casinos tecnolog√≠a q no ves ni en Nueva York, la recuperaci√≥n de la economia a millon, q esperas, REGRESATE, petrocelli, daniel ceballos https://t.co/fzIdCyyYkV",50536,98399,88172,237107
1483,"@Banesco Amigos suban ese limite diario, es muy poco 600 bolivares üò≥",66545,6709,47146,120400
1484,"@AnmariellyH As√≠ somos.. pidi√©ndole guindas al pavo como si el Bcv es la Reserva Federal de USA..los billetes que circulan son los que suelta el narcotr√°fico..somos muy exquisitos..que bolas.
!",59258,3648,74726,137632
1485,"#EsNoticia || Inmunizan a docentes tachirenses para el retorno seguro del a√±o escolar 2021-2022 (Leer+) ‚û°Ô∏èhttps://t.co/9PiJNPJRD0
#CaminosDeVictorias
@MPPEDUCACION
@_LaAvanzadora
@FreddyBernal
@Juntosxtachira1 https://t.co/N2fOyi4CU9",54002,83976,78207,216185
1486,"Los Ciclo-chatarra: j√≥venes en T√°chira que recorren kil√≥metros para ayudar a sus familias https://t.co/OH01pXZUge #tachira 
#ciclistas 
#jovenes",79411,83551,97463,260425
1487,"Vivimos en un pa√≠s de corruptos..de habilidosos...El gobierno dict√≥ las normas,para que se use como referencia el d√≥lar del BCV y esos precios se exhiban en bolivares y no en d√≥lares..es un respeto a la moneda.Deben existir fiscales en los negocios,que vigilen el proceso.
..",21101,95289,58131,174521
1488,"Acaba de publicar una foto en Coro, Falcon https://t.co/uplCq6rlNL",89254,66896,33326,189476
1489,@CarusiDra @gregorio_tx La carta bandera del gobierno es la ley #ZEE para la supuesta recuperaci√≥n econ√≥mica pero el l√≠der opositor bertucci en su programa de gobierno para el estado carabobo habla de la creaci√≥n de ZEE oposicion y gobierno apuestan a lo mismo mi pregunta #Aprobaran la indexacion #NO,43165,23485,99369,166019
1490,"Gustavo Dudamel, nuevo director musical de la √ìpera de Par√≠s https://t.co/hiaNAFqeLO  #ESPECT√ÅCULOS",22186,11785,54968,88939
1491,"#Carabobo | Comunidad La Campi√±a protest√≥ para exigir agua por las tuber√≠as (+Video)
https://t.co/CfYDjPPSmq",15803,75759,46829,138391
1492,"@CorpoelecCarabo @Banesco @CorpoelecCarabo 
@CORPOELECinfo 
@CorpoelecCar 
Las Chimeneas Valencia Parroquia San Jos√© Municipio Valencia sin electricidad hoy  15 de Octubre 07:00 pm
HASTA  CUANDO????",1759,40202,93873,135834
1493,"#T√°chira Gracias al Gobierno Bolivariano, m√°s del 30%de la poblaci√≥n ha sido vacunada contra el COVID19, y all√≠, en cada rinc√≥n est√° la @GNB_Pueblo brindando apoyo y seguridad a nuestro amado pueblo. #10Sep #GNBGDP https://t.co/qneI5lWyDe",80453,40870,56128,177451
1494,@Banesco Pago movil Banesco dando error y debutando el dinero https://t.co/VqTAWas1JJ,76951,90375,86746,254072
1495,"@EAristeguieta Lo certifico, traumatismo tor√°cico-abdominal, desprendimiento y aplastamiento de √≥rganos. 10 operaciones, hospital Carabobo "" √Ångel Larralde "", a√±o 2001. Gracias a Dios y a estos m√©dicos, incluyendo enfermeras, y todo el personal, vocaci√≥n y servicio...
Graciasssssss a todos",7973,86248,22673,116894
1496,"¬°Amemos al T√°chira! inicia recolecci√≥n de desechos en municipios del eje metropolitano, inform√≥ diputado @FreddyBernal.

@NicolasMaduro @Silfredo_Z @Juntosxtachira1 @arguelloyepfri https://t.co/tXRoHv7Hmc",73744,64890,41036,179670
1497,"Buenos d√≠as @prof_yurbe te deseo un Fabuloso d√≠a. Somos Hij@s de Bol√≠var y Ch√°vez; Nuestra labor tiene un prop√≥sito m√°s elevado, su fin es conservar nuestro Legado y consolidar la Patria Grande en un Estado de igualdad en la Diversidad

Nosotros Seguiremos Venciendo por Siempre https://t.co/EYUc4Cn98A",81806,23333,55520,160659
1498,"Desde la SEDECOAS y por instrucciones del presidente @JuanOrlandoH trabajamos para recuperar la da√±ada infraestructura educativa de nuestros ni√±os y j√≥venes.

Hoy el ministro Nelson M√°rquez, trae buenas noticias al CEB Rep√∫blica del Per√∫ en la colonia El Pedregal de Comayag√ºela. https://t.co/tqnf50qdb2",54697,23126,66585,144408
1499,"En efecto, en el primer considerando del acuerdo se se√±ala que, ‚Äúderivado de una serie de medidas implementadas por el gobierno nacional, el estado T√°chira se encuentra seriamente restringido y afectado en su comunicaci√≥n terrestre, a√©rea y fronteriza
 https://t.co/aGnrO77KgC",80257,68781,85893,234931
1500,@BcodeVenezuela @BCV_ORG_VE Ya es difunto ese de 5 https://t.co/WCOztpY2fQ,94171,44212,67902,206285
1501,"Wuu iska indho tiraya laakin siyaasi walba waa nooca.
Cadowgaagu maaha nin soomaali ah oo markaad wadan kale tagto aad iska jeceshihiin fmilygaga africa jooga. Ee ninka gaalka ah ee marka africa timaado ku tusaya inay soomali isku cadow tahayüòé",76344,22104,70080,168528
1502,"Env√≠o mis sentidas palabras de condolencias a la familia de @lanacionweb por la partida f√≠sica de Do√±a Gloria Ni√±o de Cort√©s, quien fue en vida Gerente General de este medio de comunicaci√≥n, √≠cono de la informaci√≥n en #T√°chira.

¬°Dios le conceda la paz y reciba en sus brazos! https://t.co/8VNV8x1IjC",663,28701,47106,76470
1503,"Municipios del estado T√°chira activos en la ultima semana de agosto escuelas abiertas @MPPEDUCACION 
@ZonaEducTachira 
@NicolasMaduro
@yelitzePSUV_
@charlychaves
@COMUNIDADESED15
@edward_arellano
@SPETachira 
@FreddyBernal
@DGEFDMPPE @DorisJi32185292 @arnaldo72086828 https://t.co/AZpax5AZdn",44325,22000,96788,163113
1504,@BerlitzaStar @Edinsonvh @Virgiliofuent16 @NellySu47381605 @minga133 @kfuenma Saludos cordiales desde Coro Estado Falc√≥n. Feliz Domingo,51007,71837,93863,216707
1505,Despu√©s de veinte a?os de da?os al pueblo venezolano quieren tapar el sol con un dedo ya no  m√°s enga?os salgamos a votar el 21 de noviembre para sacar este gobierno q acabo con nuestra Venezuela linda y tambi√©n  q separo miles de familias   xq salieron huyendo de esta crisis econ√≥mica tan dura,5970,9480,28724,44174
1506,"podr√≠a estar estudiando pero NO, puse la playlist m√°s sad que tengo y estoy sentada mirando a un punto fijo",2728,56827,4051,63606
1507,"Detenida banda que prostitu√≠a a adolescentes en Carabobo | #15Oct #Sucesos

https://t.co/s1zQPyPTVE",26473,87045,58377,171895
1508,"@INTi_Venezuela y @ort_falcon siguen en el establecimiento de mesas de dialogo en el Hato El Carmen Mcpio. Silva de nuestro estado Falc√≥n a fin de garantizar el trabajo en el campo y la tierra.
#PazEnElCampo.
@NicolasMaduro 
@wcastroPSUV
@davidjhg 
@AnyineyDel https://t.co/654ebi8sQD",8907,54786,35719,99412
1509,Fernando Andrade: ‚ÄúParalizado el T√°chira por falta de combustible y de electricidad‚Äù https://t.co/scNn87TR2g https://t.co/y4zFqkLQQT,15727,4363,12500,32590
1510,@cmdtemiliciab1 Comuna o nada. Venceremos. #AbrildeFuegoPatrio. ADI 121 Manaure. APDI Punta Card√≥n. Operadores d√© redes sociales.,17918,59226,20092,97236
1511,"#09Oct Cuando la batalla se recrudece, se prueba la lealtad del soldado. ¬°Aqu√≠ Nadie se Rinde! üí™üèΩüí™üèΩü¶áü¶áüáªüá™üáªüá™ #VenezuelaTieneConQu√© #carabobo #cultura #arte #lacava #docentes #sabado https://t.co/Z0xanKPXIf",13084,98054,55233,166371
1512,"109. Falcon y el Soldado de Invierno (2021)
Serie de Marvel en la que nos cuentan c√≥mo el nuevo Capit√°n Am√©rica se gana su escudo. Podr√≠a haber estado  bien, pero me he quedado igual que estaba. Tiene pase, pero muy pelado.",73562,89369,4203,167134
1513,"Laidy G√≥mez es lo mejor que tiene el T√°chira, no hay que ser ciego para votar por ella,es una luchadora democr√°tica de verdadüôèüôèüëçüëçüëç https://t.co/Qz5uK34q02",61157,62082,96003,219242
1514,"Ahora en #LaHartaSociedad conversamos con Alexandra Pedregal, Fundadora de Crasq√≠, sobre esta marca venezolana fundada en el exterior en Venezolanos de moda. #PonOnda #AsiSomos
https://t.co/gPA9klbu3X https://t.co/3PYjoBj0HO",40759,86644,29438,156841
1515,"AutorBuen Dia @joha Carrasco Durante el restablecimiento de BDVenl√≠nea y nuestros CanalesElectr√≥nicosBDV, tus operaciones se ver√°n reflejadas progresivamente. Continuamos labores para la restituci√≥n total de nuestra plataforma.",23767,16323,16092,56182
1516,"Cuidar al pueblo es el m√°ximo compromiso en el municipio Bejuma, Edo. Carabobo en el cumplimiento de las medidas de bioseguridad #GNBGDP #GNBGDPDgpayaCmdte
#24Oct #VacunarseEsVida
#CEOFANBInvictosPorVzla
@PrensaCmdteGral
@Milicia_B1
@somos_ejercito https://t.co/YuKEndDZQX",26579,78992,83746,189317
1517,@NicolasMaduro Sobretodo el Piritu estado Portuguesa el estadio de Softbol Justo Enrique Meneses tiene 15 A√±os sin Electricidad ser√° Posible que alg√∫n d√≠a Atiendan este clamor ni el Gobernador Calles y la Alcaldesa Lucidia ayudan S.O.S,94221,95554,11541,201316
1518,Seguimos avanzando en mi amado pueblo de mor√≥n. Aqu√≠ nadie se rinde. Q viva Carabobo ü¶áü¶áü¶á https://t.co/8HMQpdyO0P,21203,4392,39182,64777
1519,"Estos borregos de @IvanDuque, periodistas de @BluRadioCo se creen jueces.

Pese a financiar a Primera L√≠nea, Consejo de Estado mantiene investidura al senador Gustavo Bol√≠var https://t.co/SCQ3ozF2qO",98175,19806,36173,154154
1520,"CDI;Bella Vista. Estado Bol√≠var. 
Cada colaborador de la salud es un bastion de la Revoluci√≥n. 
#SomosDelBarrio
#Aniversario61CDR 
#CubaPorLaVida 
#CDRCuba 
@Cubacoperaven 
@PardoRegla 
@MINSAPCuba 
@unidadcdr https://t.co/3yCqEkdum7",75098,54200,59558,188856
1521,"@BcodeVenezuela Sres, por que esta apareciendo saldo negativo en la cuenta?, Por favor responda a los clientes",46154,75194,23879,145227
1522,"@rmfinanzasve @BcodeVenezuela Ministro muy bien. Saludos
No tenemos equipos Biopago",72331,55109,14187,141627
1523,"@Eldiamantenegro https://t.co/mkJq3SQBvl
Vendo salsas env√≠o a todo M√©xico ah√≠ si me pueden apoyar se los agradecer√≠a, y ya se la saben puras buenas vibras banda",61597,30170,34660,126427
1524,@Adan_Coromoto @lavozchavez1 40.000.000.000$ anuales se pueden invertir pa√≠s @NicolasMaduro @ConCiliaFlores  @TareckPSUV  @jescotet @Banesco @Bolsacaracas @Bolsa_Publica @Sunaval_Oficial @noticierovv @globovision @UNoticias @ElNacionalWeb @Mippcivzla @fedecamaras @fedeagro @Fedenaga https://t.co/2VXWpiEiaP,22294,12076,22867,57237
1525,"OCT 22
Atentos¬° A la caza del #DolarParalelo 
SUBE la tasa Oficial BCV a 4.23 Bs x $ 
#ElVerdaderoDolarAsesinoBCV #ApasodeVencedores #MonitorDolarCucuta #Dolarvzla #TasaPromedio #Divisas #Venezuela   
s√≠gueme en instagram #camarados
https://t.co/ZrzEgJpQq1 #RT https://t.co/S8WLa6GrAt",66262,38942,17202,122406
1526,"Necesito DEMASIADO despertarme en una casa frente al Mar en Chichiriviche, tucacas, Margarita, Bahia da Cata, Choroni, hasta en la guaira, pero con playa. El cemento me tiene locoooooooooo.",49270,41486,61877,152633
1527,"üö®üí∞üìä *As√≠ cotiza el d√≥lar esta ma√±ana:*

‚è±Ô∏è 27/10/21 9:00 a. m. 

4,54 (Monitor) ‚¨ÜÔ∏èüìà

4,60 (D√≥lar Today) ‚¨ÜÔ∏èüìà

4,29 (BCV) ‚¨ÜÔ∏èüìà #VenezuelaSeVacuna",71986,51941,52842,176769
1528,"@StripMarvel Wandavision a sido un soplo de aire fresco en el universo marvel,Falcon y el soldado de invierno no a estado mal pero tiene algunos agujeros de gui√≥n y es m√°s de lo mismo en Marvel,no est√° mal pero me quedo con Wandavision me a transmitido much√≠simo m√°s.",68815,5075,16326,90216
1529,Detenido venezolano tras asesinar a su pareja a pu√±aladas en Argentina https://t.co/2rmQsDnYsM,88011,26923,49834,164768
1530,"En el marco de la Mision Guardianes de la Patria en Falc√≥n la A/J @gestionperfecta dijo:

üó£Ô∏è""√âsta es la Patria Ni√±a con la que estamos plenamente comprometidos...
¬°Gracias, ni√±as y ni√±os del estado Falc√≥n por su sabidur√≠a y temple! ¬°Son grandes maestros!""

#EvitaElContagio https://t.co/NgW1NFAh4w",35302,40609,29368,105279
1531,"Producccion es el camino #ConLasManosEnLaTiza 
@charlychaves
@FreddyBernal
@ZonaEducTachira
@MPPEDUCACION
@YvkeTachira @BermudezJoseA
@jhonnyc1501
@fundacion_ribas
@PSUVTachira https://t.co/vTMHWZ2bCR",21317,78294,33664,133275
1532,Gobernadora del T√°chira: No tener primarias es una conducta similar al chavismo https://t.co/lvr9Xnuifm,24282,68086,28956,121324
1533,"üí®Excelentes im√°genes de este atardecer de #Lunes de nubes mastod√≥ntica en #PiedrasNegras.

‚û°Ô∏èLas cuales aparecen debido a posible tiempo severo son comunes esta nubes en los meses de abril, mayo y junio.

 üì∏  Cr√©dito: Tom√°s Escare√±o. https://t.co/LUUU2syGS4",34889,68544,30935,134368
1534,le√≠ en instagram a una que cont√≥ que la primera vez q le rompieron el coraz√≥n se sinti√≥ como si el mundo por primera vez no fuera infinito y ahora estoy completamente devastada mirando un punto fijo en la pared,33233,31027,1150,65410
1535,@raulrivas05_1 Aguas termales las tricheras edo. Carabobo,96321,24226,14129,134676
1536,Mis fds en el club naval o pedregal con mi fam y mi √∫nica preocupaci√≥n era q Helado iba a pedir al final de la piscina ü•∫‚ú®üíñ lindos recuerdos ü§ß https://t.co/ts57YXBn7Z,43540,15803,31183,90526
1537,"CON M√ÅXIMO COMPROMISO PATRIO! üëäüáªüá™
#17Oct üé• El MG Juvenal Fern√°ndez L√≥pez @GNBCmdtGral, realiz√≥ visita en el Comando de Zona @GNB41_CARABOBO acompa√±ado del Cmdte de Zona GBN.
#Dcr458
#LaVerdadSiempreTriunfa
#PuebloYCEOFANBVenceremos https://t.co/9wj2lXnvjE",18992,27962,72037,118991
1538,"Acaba de publicar una foto en Punto Fijo, Estado Falc√≥n, Venezuela https://t.co/geZI2iADR4",78171,39072,62610,179853
1539,#Ma√±ana 25 de abril #1erDebateEnL√≠nea con candidatos y candidatas de #PiedrasNegras a las 11:00hrs. Sigue la transmisi√≥n por Facebook y YouTube del @IECoahuila. #NoTeLoPierdas #Coahuila https://t.co/McliTmMIOv,11414,95359,99711,206484
1540,En la labor un momento para un antojo en Villa Gorgona Candelaria https://t.co/ofnnk3iqg3,3701,32090,11800,47591
1541,"@kiara_true Bueno, te cuento que en El Palmar, un pueblo del estado Bol√≠var (estado donde se genera la mayor parte de la energ√≠a del pa√≠s) pas√≥ 36 horas sin energ√≠a el√©ctrica. Desde ayer a las 11am hasta ahora acaban de restablecer el servicio.",27941,36878,70856,135675
1542,"@BcodeVenezuela No funciona b√≥veda en l√≠nea, pod√©is verlo ?",197,74593,3591,78381
1543,"üîµ#03Oct | #Domingo  #AHORA 06:42 pm OTRA VEZ #SinAgua en #LaIsabelica, #Valencia #Carabobo 
¬øY el #Agua pa cuando?
¬øC√≥mo vamos a prevenir #Covid_19?
#VacunateSinCita
El racionamiento es Martes y Viernes
#ATENCI√ìN
.@Hidrocentro2011
.@MPPAAguas
.@rafaellacava10 
.@EvelynBVasquez",51866,10323,83469,145658
1544,"La #GNBFalc√≥n  Seguimos en Batalla Victoriosa Comprometidos en garantizar la Paz y Bienestar del Pueblo Venezolano.
#29Mar
#Cu√≠dateDeLaCovid19
#GNBAlertaJuntoAlPueblo
#FANBEnDefensaDeLaDignidad 
.@NicolasMaduro 
.@cmdtegralgnb
.@GNBGDjuvenal
.@LopezvargasR https://t.co/MGZK31GgiB",36352,946,70963,108261
1545,"Buenos d√≠as @MARIATAFURLOPEZ te deseo un Fabuloso d√≠a Somos Hij@s de Bol√≠var y Ch√°vez Nuestra labor tiene un prop√≥sito m√°s elevado su fin es conservar nuestro Legado y consolidar la Patria Grande en un Estado de igualdad en la Diversidad

Nosotros Seguiremos Venciendo por Siempre https://t.co/mD3pG0HFZf",44375,3722,36820,84917
1546,"@b4dmachine pues era ni√±a, ten√≠a como 8 a√±os y era de madrugada, estaba lloviendo y me di√≥ fr√≠o as√≠ que me iba a cobijar cuando de repente cay√≥ un rel√°mpago y tron√≥ alv, vi la silueta de un hombre con sombrero en la ventana",69331,19367,51814,140512
1547,Feliz noche. Saludos cordiales desde Coro Estado Falc√≥n  @BlancoKarilys,63298,42292,97249,202839
1548,"Ahora tendr√°s la Unidad de Tributos Internos Puerto Cabello en la Aduana Principal Mar√≠tima de Puerto Cabello, estado Carabobo #SeniatTrabajaParaTi  @SENIAT_Oficial  #SeniatRumboAlBolivarDigital #VenezuelaTieneConQue #ChavismoVictoriaPerfecta https://t.co/rjHMCmALle",7387,93917,18980,120284
1549,L√≠der nacional del partido El Cambio recibi√≥ el respaldo a su candidatura por parte del movimiento ‚ÄùUniversitarios por Carabobo‚Äù https://t.co/Z0Mz0BTx3o,71303,2622,92852,166777
1550,#14Oct Javier Bertucci: ‚ÄúCarabobo necesita un gobernador al que le duela la gente‚Äù https://t.co/e9Ho6wI4Sk https://t.co/ZAPrEYWi6M,57323,2144,30318,89785
1551,"S O.S. VALENCIA...
Plaza Montes de Ocaüò™
Av Bolivar Norte.
Parroquia San Jos√©. 
Municipio Valencia. 
Estado Carabobo. https://t.co/2KtSLlpaRJ",78524,12057,67015,157596
1552,"Montos diarios reexpresados.

#RumboAlBol√≠varDigital #BCV #DELSUROnlineEmpresas #DELSURBancoResponsable #delsuronlinepersonas #comercio #Persona #personajuridica #bol√≠vardigital #empresas #P2C #vzla #oriental #central #guayana #occidental #BCV https://t.co/X8CF4FPJzg",6384,66693,46494,119571
1553,"@Gabyosoriohdz Arregle el problema del agua, queremos banquetas dignas en la Colonia Pedregal de San Nicol√°s, alumbrado p√∫blico de primera. P√≥ngase a trabajar, visite las comunidades",69618,84273,1397,155288
1554,"#LasBuscamos Laura Yesenia Castro y Samantha Fabela Castro, 32 y 17 a√±os,15/1/17 de #PiedrasNegras #Coahuila a #Tamaulipas #911 https://t.co/j6SeN6BSm7",69305,8763,53965,132033
1555,"...influenza en un s√≥lo d√≠a, gracias a √©l mi madre est√° viva pues fue quien nos mand√≥ con una onc√≥loga maravillosa que la ha sacado adelante, ese hombre, ese m√©dico, ya no est√°. 
Dio su vida por salvar la de otros en el √Ångeles del pedregal y en el siglo XXI...",73570,63018,31707,168295
1556,"Les escribo, para saber si la mejor instituci√≥n bancaria de Venezuela y del Estada puedo resolverme el problema que la misma instituci√≥n me creo, esto si es socialismo me congelan el dinero de los pobres clientes. Y despu√©s dicen que los opositores no tienen raz√≥n cuando dec√≠an que nos quitar√≠an nuestro dinero!",95752,83616,60750,240118
1557,#18Oct üóûÔ∏è | Bancos venezolanos tendr√°n menos presi√≥n para vender los d√≥lares inyectados por el BCV https://t.co/WA9VOWYE9n,57537,63924,5395,126856
1558,#06Oct Nuetra nueva generaci√≥n de oro incrementa nuestros #PieDeLucha @NicolasMaduro @vladimirpadrino @wistohor @ZODI45_Carabobo @ADI_Tacarigua @ADI_Tacarigua @Apdi_losguayos https://t.co/TJZEuSi3Jp,20494,16099,87196,123789
1559,"De acuerdo con la empresa de Transporte Masivo, la¬†nueva ruta llamada T536 Zona Paga Metro Pedregal ‚Äì Corredor Norte ‚Äì San Isidro beneficiar√° a los usuario del √°rea Este y realizar√° otra mejora operativa en el sector de Bel√©n.
https://t.co/Mgv7P0NHzO",19587,30245,98540,148372
1560,@vladimirpadrino OPERADOR RRSS DEL ADI 122 Urumaco,85250,4698,92854,182802
1561,¬°Arrestado! Poderoso narco falconiano relacionado con c√∫pula de Maduro                    https://t.co/SDNu151eIW,53622,79240,97470,230332
1562,"La #GNBFalc√≥n realiz√≥ Despliegue con el fin de garantizar el cumplimiento de las medidas de Bioseguridad. 
#31Mar #FANB #GNB
#TodosContraElVirus
#GNByPuebloAlerta
#FANBEnDefensaDeLaDignidad 
.@NicolasMaduro 
.@cmdtegralgnb
.@GNBGDjuvenal
.@LopezvargasR https://t.co/H1x4a3Hwi9",12981,8880,42768,64629
1563,Brasil representa una cuarta parte de las muertes diarias por covid-19 en el mundo https://t.co/1iFChNInd9  #INTERNACIONALES,35169,31774,7479,74422
1564,"#11Abr | Coro ha sido centro de poder pol√≠tico: fue la primera capital de la Provincia de Venezuela, y luego capital de otras entidades: Provincia de Coro, estado de Coro, estado Falc√≥n, y estado Falc√≥n-Zulia.

#FelizDomingo #FalconLoTieneTodo  @willymedina8 @BarberaMinistro https://t.co/6LyRqJAe4C",36364,24441,60369,121174
1565,"@Noelleal Banesco fue la plataforma bancaria utilizada por el chavismo desde sus inicios para pagos y transferencias internacionales. El posee toda la informaci√≥n de las cuentas y sus titulares a quienes se hicieron tales transferencias; por ello, es ‚Äúintocable‚Äù por el chavismo.",57975,48241,52803,159019
1566,"La Prensa de Hoy /// @nuevodiaenlinea del Domingo 25 de Abril de 2021
-
-
#portadas #prensa #informacion #titulares #portadas #diarios en Punto Fijo, Estado Falc√≥n, Venezuela https://t.co/quwghylOaI",42174,48552,51295,142021
1567,"‚úÖ Realizar punto fijo de seguridad en el redondel del sector de la Terminal Terrestre.

Un trabajo en conjunto de la @azuayinten, Comisar√≠a de Polic√≠a, Teniente Pol√≠tico de la Octavio Cordero, @PoliciaEcuador, @FFAAECUADOR, @PolmunicipalGC y @emov_ep. https://t.co/ZJYFILFr2B",7418,9260,42326,59004
1568,"V√≠ctor Clark: Juntos Por Falc√≥n debe llegar donde normalmente no llega la acci√≥n de gobierno
https://t.co/zjUQWQ4bAU

Este mi√©rcoles el gobernador V√≠ctor Clark, destac√≥ el importante esfuerzo que realiza el¬† Plan Juntos Por Falc√≥n 
#TodosContraElVirus https://t.co/iOHSv33MeE",2226,95107,33517,130850
1569,tan noble deporte en un gesto de acci√≥n social. El contrato de servicio est√° a nombre de la Universidad Nacional Experimental del T√°chira y no en el de la asociaci√≥n de profesores que es una comunidad sin fines de lucro... Adem√°s de todo lo anterior hidrosuroeste hace caso omiso,35311,52023,6222,93556
1570,"Hoy #3Oct se conmemoran 207 a√±os de la Batalla de Las Trincheras (1813), en Carabobo, en la que el Ej√©rcito Libertador, dirigido por el h√©roe Luciano D'Elhuyar, venci√≥ a las tropas realistas, vengando la muerte de Girardot tres d√≠as antes en B√°rbula.

#Vac√∫nateSinCita https://t.co/YuzjwGYD95",92953,72171,15181,180305
1571,"El BCV es ahora inventor de nuevas teor√≠as de econom√≠a, que triste esa gente que dirige los destino de esta instituci√≥n https://t.co/8JOjjrjacj",37515,53862,78592,169969
1572,"M√ÅXIMO COMPROMISO PATRIO! üëäüáªüá™ #17Oct üé• El MG Juvenal Fern√°ndez L√≥pez @GNBCmdtGral, realiz√≥ visita en el Comando de Zona @GNB41_CARABOBO acompa√±ado del Cmdte de Zona GB @Rivera_bastardo
#LaVerdadSiempreTriunfa
#PuebloYCEOFANBVenceremos
#GNBOfAuxGuarumito https://t.co/3bCYLqUa0n",40101,78623,15849,134573
1573,"Gustavo Bol√≠var mantendr√° su curul en el Senado: Consejo de Estado no le quit√≥ su investidura - Infobae
QUE DESGRACIA TAN HP. CUANDO NOS LIBRAREMOS D ESTE Y OTROS DEMONIOS https://t.co/QO58z4yx3e",74677,31874,53566,160117
1574,"Tras la captura de 'Chiche Smith', vale la pena recordar qu el llamado Cartel de Paraguan√° operaba no s√≥lo bajo autorizaci√≥n del r√©gimen de Nicol√°s Maduro, sino con la participaci√≥n activa de muchos de sus autoridades nacionales y locales https://t.co/gQK4i6dr2Z",43165,33516,61187,137868
1575,Ninguno de esos cr√≠ticones fue mi empleador y ninguno es de la clase social santa Elena Pedregal monte real ok? No me interesan las mujeres y los casos de esos payasos reunidos en casas no siendo de esa clase social,8122,60475,49218,117815
1576,"@PresidencialVen Buenos d√≠as Sr. Presidente el Bono Complementario deber√≠a ser para todos los maestros, habemos muchos que a√∫n no lo recibimos ni agosto ni septiembre.... Haga una revisi√≥n al respecto, aqu√≠ en el estado Bol√≠var es un desastre, sin muchos los docentes que no se lo pagaron",76160,75739,71718,223617
1577,Junior Gonz√°lez Rojas No van a reponer el dinero? osea que robaron jsjsjsjsj,61586,3163,68943,133692
1578,"@cielo_rusinque @RoyBarreras Su compromiso ""desinteresado"" siempre ha estado ah√≠. No hay duda.
Adem√°s, el necesitaba el rayo iluminador y nada mejor que Petro.
No olvidar que Bol√≠var le otorg√≥ premio por ""lagarto y acomodado en la mejor sombra""
https://t.co/v4jQ7D8Fr6",72902,89247,8313,170462
1579,"@cmmzodic @NicolasMaduro @ZODI45_Carabobo @dhernandezlarez @wistohor #MiliciaBolivariana venceremos
#PieDeLucha
#HistoriaDeLaMiliciaBol√≠variana
@Nicolasmaduro
@vladimirpadrino
@dhernandezlarez
@Libertad003
@PrensaFanb",61551,44211,69351,175113
1580,"M√©danos de coro

I vote #Dynamite for #BestMusicVideo at the #iHeartAwards @BTS_twt https://t.co/ptmEIXLFOX",14281,25440,3282,43003
1581,"Estado carabobo CDI Bella Florida 
Cuba tiene el orgullo de contar con un ej√©rcito humanista, solidario e internacionalista. #CheM√©dicoInternacionalista
#CubaPorLaVida #CubaCoopera 
@cubacooperaven https://t.co/SfQ12GF5NR",87941,29494,22158,139593
1582,"Usuarios de la empresa de televisi√≥n por cable e internet,  Inter, en el estado Carabobo, estan alarmados por el pregresivo aumento de la empresa, lo cual clientela se llevo una sorpresa por cobro exesivo que pagaron en facturaci√≥n hasta 50% de aumento #inter #carabobo. #octubre",36113,17448,96972,150533
1583,"@el_carabobeno Mafia de la gasolina subsidiada haciendo de las suyas en la Bomba Santa Ana II de Naguanagua-Carabobo, hoy lleg√≥ la gandola, rifaron 60 tickes a 30 lts c/u, son 1.800 lts, y el resto de la gasolina subsidiada a donde se va.",22244,87240,56398,165882
1584,"A mi nomas me parece o a alguien mas le est√° dando un dejav√∫ de Olimpia- Tachira ac√°, si sigue as√≠.. tipo est√°n jugando a muerte, para salvarle a un t√©cnico mediocre que deja que hagan lo que quieran.",33438,86658,85079,205175
1585,"@alimentosatual1 @Orangecolective @Banesco Tienen un tema con Cantv, me pas√≥ igual e intente entrar con los datos de mi tel√©fono y si pude.",33003,98861,8209,140073
1586,"Mi mam√° empez√≥ vendiendo helados y mi hermana revendiendo productos, hoy luego de un a√±o invirtieron y tienen su proyecto. Siganlas en ig cm @trendgy.sc, PD tienen un sorteo para todas las damas. #Tachira #SanCristobal #sc #Venezuela #Cordero #tariba https://t.co/zGjkE1CKpW",95848,63382,58265,217495
1587,"@luisoliveros13 @richardvlnc Oliveros esos datos que das son del BCV, que todos sabes que miente descaradamente, el Fondo Monetario Internacional (FMI), calcul√≥ ese √≠ndice en 1.370.000%.

El ex-Parlamento, calculo que lla inflaci√≥n cerr√≥ 2018 en 1.698.844,2 %.",30834,17972,79213,128019
1588,"#11OctüìçEfectivos Adscritos al @GNB41_CARABOBO, realizaron la retenci√≥n de un veh√≠culo tipo camion el cual transportaba materia prima sin ning√∫n tipo de documentacion. #GNBCaraboboSeguro CentinelasDeLaPatria
#Flexibilizaci√≥nConsciente
PorlaPatriaCEOFANB 
.@libertad003 https://t.co/Zx3HuQAjw5",41590,37,67499,109126
1589,#Enterate Contin√∫an los trabajos de impermeabilizaci√≥n en ala norte @hospimilTachira por parte @ServiciosMPPDVe efectuando reparaci√≥n de canales de aguas de lluvia y uni√≥n en manto asf√°ltico. #Falta1DiaParaEl33Aniversario üáªüá™ #Tachira https://t.co/ag1MWjh02p,75395,55601,8041,139037
1590,"@SomosMovilnet_ @BcodeVenezuela En esto si se esmeran, en lo que refiere al cobro, pero no repeean las fallas que hay en la parroquia Andr√©s Eloy Blanco, municipio piar estado Bolivar, hace casi un a√±o el servicio es intermitente se cae por d√≠as y cuando vuelve es por apenas horas.",80287,52852,71032,204171
1591,"Videoconferencia de Lidia Falc√≥n y Arussi Unda: La polic√≠a queer: censura, denuncias y cancelaci√≥n
https://t.co/Tc6WMxlQmK",43702,51812,74892,170406
1592,"Codehciu: ""La violencia contra la mujer es una violaci√≥n a los derechos humanos y un grave problema de salud p√∫blica que debe ser abordado de forma intersectorial y de forma diferenciada‚Äù

https://t.co/R6LYVm0fj1",31507,99069,11301,141877
1593,"Saludos compatriota y combatiente revolucionaria.como saber que en realidad est√° p√°gina pertenece a usted ? He sigo varias p√°ginas de mis camaradas y compatriotas y luego las he eliminado porque me he dado cuenta que no son de quienes dicen ser. Soy un compatriota y combatiente revoluci√≥n igual que usted y aportar para el bienestar de nuestra patria y nuestra revoluci√≥n es lo que hago. Porque a pesar de las adversidades que han tocado vivir siempre he sido fiel a mi patria . LEALES SIEMPRE , TRAIDORES NUNCA.  NOSOTROS VENCEREMOS. ",53239,42606,7309,103154
1594,@Guillermo_Ferre Epa bro. Punto Fijo,62628,52160,61435,176223
1595,"D√≥lar oficial cerr√≥ este martes #5Octubre en Bs. 4,19 seg√∫n publica el #BCV.

Salario m√≠nimo y pensi√≥n del #IVSS mensual Bs. 7 ($1,67) https://t.co/HjG7pg0b13",6506,23249,62014,91769
1596,"@x__girlalmighty hermano.

Lo veia como su venganza, ahora su enojo se hab√≠a concentrado en √©l. Acepto la cajetilla tomando uno y ofreci√≥ de su cerveza mirando a u  punto fijo en el espacio delante de ella.‚îÄ‚îÄ

No se me da bien. . . Hablar. ¬øTu est√°s bien?",33903,63928,95780,193611
1597,"Cosas por resolver en #Guayana
* El mercado negro de la gasolina.
* La compra y venta de oro y d√≥lares.
* Los negocios de los chinos reciben los $ a precio del BCV pero los precios en bs de los productos cambian a diario. (Ojo con esa trampa)
* Nunca tienen cambio para $",12405,59713,21086,93204
1598,"@BcodeVenezuela Saludos! Por favor mi contrase√±a de BDV en l√≠nea natural se venci√≥ y desde ayer intento ingresar por autogesti√≥n y no ha sido posible hacer el cambio porque el sistema no me lo permite, y no me da opci√≥n al #3 que es el cambio de contrase√±a!",19084,35702,39341,94127
1599,Por favor m√©tale el ojo el transporte carlos Arvelo que cubre ruta G√ºig√ºe edo Carabobo con Maracay edo Aragua hace un mes aumento pasaje el doble de 2 millones lo llevo a 4 y el d√≠a de ayer le aumento 1 mill√≥n m√°s total pasaje 5 millones en un mes,87049,79703,60353,227105
1600,"@bcodevenezuela @rmfinanzasve @delcyrodriguezv  
1/5 la Directora De la Capital 3 la se√±ora Aminta Zambrano junto a la Jefa pyme se han convertido en una pesadilla en toda la capital 3,le gusta maltratar humillara,amenazar, manipular y atropellar a los trabajadores sin importarle",22782,24630,70952,118364
1601,"@Eduardo55398554 @jeffgernst @dadams7308 @UniNoticias No est√° en contienda pero fijo hace la jugada para parecer m√°gicamente en el poder, ya ver√°, y ojal√° se cumpla su segundo punto de vista, porque nuestro pa√≠s est√° destruido y necesitamos de personas que lleguen a levantarnos de esta miseria en la que vivimos",34500,6275,98522,139297
1602,"La #GNBFalc√≥n, comprometido en garantizar la Paz y Bienestar del pueblo hacen entrega de volantes para cualquier #Denuncia. 
#11Abr #FANB #GNB
#Rebeld√≠aBicentenaria
#GNByPuebloUnido
#YoSoyFANB
.@NicolasMaduro 
.@cmdtegralgnb
.@GNBGDjuvenal
.@LopezvargasR https://t.co/oTQ1SPnO1f",91070,22785,33895,147750
1603,"CON M√ÅXIMO COMPROMISO PATRIO! üëäüáªüá™
#17Oct üé• El MG Juvenal Fern√°ndez L√≥pez @GNBCmdtGral, realiz√≥ visita en el Comando de Zona @GNB41_CARABOBO acompa√±ado del Cmdte de Zona GB @Rivera_bastardo.
#GNBAragua
#LaVerdadSiempreTriunfa
#PuebloYCEOFANBVenceremos https://t.co/5NJQIn3FVF",47794,39226,69516,156536
1604,"En el @PacMesonesanz de Barcelona, fue capturado ciudadano requerido por el MP de Carabobo por hurto calificado #GNBAnzoategui #15Oct #VacunarseDependeDeTi PuebloYCEOFANBPorVzla
#PuebloVencedor
#VacunarseDependeDeTi 
.@libertad003
.@GNBCmdtGral
 https://t.co/OGuUstL4PA",99307,30934,66117,196358
1605,"@BcodeVenezuela Buenas tardes, hace 5 d√≠as pase la tarjeta y di√≥ error en el punto y resulta que el banco lo d√©bito. D√≥nde puedo hacer el reclamo a parte de ir a alguna agencia?",75778,65955,1762,143495
1606,"#LOCALES |  Las recientes precipitaciones que han afectado a varias zonas del pa√≠s han incidido en el retraso de la llegada de las gandolas de combustible al T√°chira, seg√∫n inform√≥ este viernes Nellyver Lugo. #27Ago 
https://t.co/ByDgGLhTUz",43282,67772,25630,136684
1607,"@jomontenegro73 @elgochoceballos Si con esa cara de m......
 Por respeto a Johanna no termino la palabra, vagabundo traidor..üò°
Eres tremendo cinico colaboracionista..",87535,3200,99109,189844
1608,"@MariedgyAC El pago de la pr√≥rroga se hace desde la pag de Saime por mercantil o la plataforma de biopagos del BDV. Y seg√∫n la gaceta ofic 42.092 de fines de marzo de este a√±o, s√≥lo podr√°s tener 1 pr√≥rroga x 5 a√±os (todo el mundo, de hecho). Despu√©s debes sacar psspt nuevo (el de 10 a√±os).",91424,16140,49467,157031
1609,"SE CAEN LAS CARETAS EN EL T√ÅCHIRA: los presidentes de la Asociaci√≥n de Ganaderos del T√°chira y de la Asociaci√≥n de Avicultores del T√°chira dieron su apoyo al candidato del PSUV, Freddy Bernal. El presidente de Asogata es hermano de la diputada de VP @SoniaMedinaSC , hoy exiliada.",62490,45739,34181,142410
1610,"Hola Almiranta Carmen Mel√©ndez. Yo no soy de Caracas, pero le escrib√≠ al correo Gesti√≥n Perfecta porque tengo un planteamiento productivo y una gran necesidad relacionada con mi salud. No puedo e tender como he escrito a Usted, al Gobernador, al Mismo Presidente Nicol√°s Maduro. Y que no tenga yo una respuesta pronta y oportuna. Yo tambi√©n soy Venezolano y he dado mucho por el proyecto revolucionario del Comandante Ch√°vez. Se siente uno solo cuando con tristeza se da cuenta uno que no lo toman en cuenta en lo absoluto. Este mi mensaje seguramente quedar√° como muchos tantos en el olvido de un nunca jam√°s como tantas promesas incumplidas... ",63005,32494,45381,140880
1611,"El Consulado General de Colombia en Sao Paulo üáßüá∑ anuncia una nueva jornada de #ConsuladoM√≥vil en la ciudad de Belo Horizonte del 1 al 3 de septiembre.

Agende su citaüëá
https://t.co/Vfjdxlgx9L https://t.co/HOhwXXauSA",22436,6200,75412,104048
1612,"@cmmzodic @NicolasMaduro @ZODI45_Carabobo @dhernandezlarez @wistohor con compromiso de lucha la #MiliciaBolivariana se integra a las operaciones de escudo Bolivariano 
@NicolasMaduro 
@vladimirpadrino 
@wistohor 
@dhernandezlarez 
@ZODI45_Carabobo  
@libertad003 
@452Vigirima 
@apdiyagua2 
#MiliciaBolivariana 
#PieDeLucha",65897,48054,80366,194317
1613,"@elgochoceballos Es que tuvo su momento  de ser pendejo hasta ah√≠,  pasaste a ser otro cad√°ver pol√≠tico,  delincuente,  mercader.",76339,33092,33708,143139
1614,"#01Oct A cualquiera le puede gustar su trabajo ‚Ä¶ Para amar tu trabajo no es suficiente, debes dar tu pasi√≥n a tu trabajo. ¬°Aqu√≠ Nadie se Rinde! üí™üèΩüí™üèΩü¶áü¶á #RumboAlBol√≠varDigital #carabobo #aquinadieserinde #lacava #docentes #viernes https://t.co/FLslJrlqkT",73604,32869,9267,115740
1615,"‚ÄúChiche‚Äù Smith, de 67 a√±os de edad, has sido acusado por presuntamente ser el principal cabecilla del ‚ÄúCartel de Paraguan√°‚Äù, una organizaci√≥n narcotraficante que ha enviado toneladas de droga a trav√©s de El Caribe.
-
-
M√°s detalles en el link:
https://t.co/sdpAU07REF",99099,234,29538,128871
1616,"BCV sigui√≥ inyectando divisas por segundo d√≠a seguido: D√≥lar oficial sube a Bs.4,1945 mientras el paralelo se derrumba https://t.co/zGW3FOtf8S",31281,76145,47126,154552
1617,"#20Oct En el marco del a√±o Bicentenario de la Batalla de Carabobo bajo las instrucciones del Director General @policiafla01 Realizan Recorrido en casco central de @LinaresPotenci1 para fortalecer la seguridad @NicolasMaduro
@Zamora_PSUV_ #PuebloQueProduceYVence https://t.co/BDr0bSCTtX",64901,18679,9246,92826
1618,"@Yasde @claudiapapo BDV: operacion #7116 por PagoClave al 04168879230 Bs 5,00 comision Bs 0,01. Fecha: 29-10-21 - 17:30 Inf: 0500MICLAVE",64119,58119,270,122508
1619,"#18agosto #Ganaderos del #T√°chira luchan por los precios justos de sus #productos / Los productores tenemos que buscar la forma de ingeni√°rnosla para seguir produciendo por el tema de los insumos y la gasolina...

https://t.co/TMV0A3OmwE https://t.co/6DqUajZ1TX",4155,88942,92257,185354
1620,"Acaba de publicar una foto en Coro, Falcon https://t.co/YoO78urp1R",59116,93152,82488,234756
1621,@CorpoelecCarabo @UsoRacional Municipio Miguel pe√±a valencia carabobo  muchos sectores sin electricidad!,64765,95001,6964,166730
1622,"identidad, alimentaci√≥n y defensa. Porque Ciudad Guayana tiene con qu√©. Seguimos avanzando con nuestro hermano @OviedoPSUV, 
 porque 
¬°Juntos lo Hacemos Mejor!
@amarcanopsuv, candidato a la Gobernaci√≥n del estado Bol√≠var*
#LoEstamosHaciendoBien",5608,91704,84949,182261
1623,"TEATRO MUNICIPAL ""SIMON BOLIVAR"" CIUDAD BOLIVIA / PEDRAZA/ BARINAS/ VENEZUELA /  CAPITAL DE LOS RIOS MAS HERMOSOS DE NUESTRO  PAIS https://t.co/pNUnj8RmRY",81030,84965,92215,258210
1624,M√°s de 85% de los laboratorios en los centros de salud p√∫blica de Carabobo no¬†funcionan https://t.co/Q6BaR4yHCM,57715,91927,71559,221201
1625,@TuMundoInter Buen d√≠a desde hace un mes estamos sin se√±al Inter en el centro de San Mateo Municipio Bolivar del Estado Aragua. Los t√©cnicos estuvieron por la zona la semana pasada pero no solventaron la situaci√≥n. Agradezco su colaboraci√≥n al respecto,36734,54193,73178,164105
1626,"Como es posible? Aqu√≠ en T√°chira si le tienen sabote√≥ al Bs y es el mismo gobierno de la mano del protector, diputado a la asamblea nacional y ahora candidato a la gobernaci√≥n del estado T√°chira impidiendo pagar con bs, con el sistema Patria. No se si @NicolasMaduro lo sabe. https://t.co/5wUuNWQXG2",82757,70447,47784,200988
1627,"‚ù§Ô∏èüá®üá∫ CDI Libertad Estado Tachira#H√©roesDeLaSalud 
#ACubaPonleCoraz√≥n #CubaPorLaVida @cubacooperaven @MINSAPCuba 
@japortalmiranda @PardoRegla https://t.co/vbvhJ5CGmf",68505,96921,82289,247715
1628,@RNVinformativa @dcabellor Pongamos un n√∫mero telef√≥nico corto para accesar al BCV y saber la cotizaci√≥n del d√≥lar por SMS.,5709,89259,4184,99152
1629,"@YosefMel Habla paja de Banesco pero ahi estan; pariendo los clavos de Cristo y ""comprando"" las cholas de Moises",47245,66460,56384,170089
1630,"@AnunciaYa Kit Nintendo Dsi por 2$, incluye: 01 Lector de Tarjeta MicroSD, 03 Protector de Pantalla y 03 L√°pices punta de goma. #Nintendo #DSI #Game #Vende #VenVariedades #Carabobo #Valencia #SanDiego #mercadolibre https://t.co/HtqYnDXGZ1 https://t.co/y810deR0pH",91140,13257,19390,123787
1631,@GNBCmdtGral @GNB41_CARABOBO @Rivera_bastardo Venceremos üëäüáªüá™,96997,77152,32734,206883
1632,"@PresidencialVE Personal de Salud en Tachira, esperan sean honrados los pagos por Homologaci√≥n Acta Convenio de las cl√°usulas aprobadas el 21Junio, con incidencias salariales en bono vacacional, contrato variable (BN,DOM,FER).Diferencia Uniformes y otros. ""Salud Somos Todos"".",32906,33315,29597,95818
1633,"@Maridimarco @maigongh @Banesco yo tampoco me puedo conectar por la computadora hace dias, solo por el telefono desde la aplicacion de banesco",10032,73017,53845,136894
1634,"@Edurodriguezg Buenos d√≠as üáªüá™
#saludoplanetario desde la Ciudad Marquesa Barinas tierra llanera a la faldas del pie de monte andino #VenezuelaNecesitaUnNuevoDespertarüáªüá™",45922,26027,82542,154491
1635,21:48 en Los Angeles Incendio menor (10-0-1) B-9 Los Mitimaes y Los Arawak https://t.co/xiUowpAFS8,12584,13867,8617,35068
1636,"#Valencia 94.3 FM | El presidente del Colegio de Enfermeros del Estado Carabobo, denunci√≥ el estado de deterioro en que se encuentra la Escuela de Enfermer√≠a de la¬† Facultad de Ciencias de la Salud de la Universidad de Carabobo ‚Äì V√≠a El Carabobe√±o. https://t.co/uzxUxR0RLz",41011,38506,66797,146314
1637,"#RT @seniat_falcon: En el SENIAT seguimos laborando con todas las medidas de bioseguridad por el bienestar del pueblo. Nuestro portal te garantiza la seguridad de tus tramites de manera efectiva y segura, desde la comodidad de tu hogar #LaPrevenci√≥nEsCla‚Ä¶ https://t.co/vrU0gQNymw",2725,95393,99501,197619
1638,"#11Sep Hoy celebramos a la Virgen de Coromoto, venerada no solo en Guanare donde se encuentra su Bas√≠lica, sino en todo el pa√≠s, de all√≠ que sea conocida como ""La Patrona de #Venezuela"" üáªüá™ A ella nuestras plegarias üôè

@AlbitaTeresa 
@laidygomezf 
@GobiernoTachira https://t.co/0WV5YGHFwS",44262,48164,67989,160415
1639,"@lucilangelm Y nosotros, los clientes, disponer de la informaci√≥n del d√≠a para poder reclamar nuestros derechos!üò°El tweet @BCV_ORG_VE publica a diario y bien temprano, el tipo de cambio de ese d√≠a. ¬°Defendamos nuestros derechos de consumidores. @sundde_ve @AdolfoP_Oficial",48216,90937,74652,213805
1640,#Falc√≥nysoldadodeinvierno #Disney #Marvel ‚ÄúFalcon y el soldado del invierno‚Äù:¬øCu√°nto deber√≠a ganar un Avenger? Anthony Mackie y Sebastian Stan le responden a El Comercio | VIDEO - El Comercio Per√∫ https://t.co/womJ6h0lRT,25203,54421,69804,149428
1641,¬°EN CARABOBO! Detienen a 6 miembros de una banda dedicada al tr√°fico de personas https://t.co/SLpw4TQqU9 https://t.co/So7d83jSC6,35456,28897,1250,65603
1642,¬°LE CONTAMOS! Sundde cerr√≥ tiendas Traki temporalmente por remarcaje de precios y cobro a tasa distinta a la del BCV: ‚ÄúEs inaceptable‚Äù #12Oct #Venezuela  https://t.co/iojLuL4mCB,86358,27376,80213,193947
1643,"Lic. Lic. @luislarahn Porque al Equipo Mil√°n de la Liga el pedregal le dicen La M√°quina del Mal?
@ca_acosta
@fervarelahn",85587,46410,40068,172065
1644,@orellana_merwin @Campananews @avilaelguerrero Tasa del BCV a que se refiere...,22201,49881,15956,88038
1645,@NestorLReverol mira narco tu en tu casa tienes planta el√©ctrica maldito malparido aqu√≠ en carabobo en Valencia no hubo luz desde las 12 am y lleg√≥ alas 9 am y se ha ido y venido m√°s de diez  veces quien responde maldito por los artefactos el√©ctricos,43659,82089,50928,176676
1646,"En la Venezuela de los apagones, llegan carros el√©ctricos https://t.co/NtGyrkMO4L  #NACIONALES",31432,94450,82519,208401
1647,"Un total de 01 tonelada de Material Ferroso fueron recuperados, gracias a las labores de patrullaje de los  efectivos castrenses de la .@GNB41_CARABOBO #GNBCaraboboSeguro #13Oct  PuebloPatriota #GNB4taD411Carabobo
#Mon√≥merosEsDeVenezuela
UnidosPuebloyGNBEsSoberan√≠a
.@libertad003 https://t.co/HDu9paH85T",21544,41651,81805,145000
1648,"@mercadosyaccion @Banesco Que bien ....! ..
Le ha ido a Escotet ! ..
Los 22 a√±os en sociedad con el  chavizmo narco terrorista y asesino ...! 
... lo hicieron m√°s rico ! 
Por supuesto ...
En Espa√±a üá™üá∏ .. 
Se mueven capitales chaviztas ....
All√≠ el .. clavo !!",80188,12864,56469,149521
1649,@CFE_Contigo trono un transformador en Fuentes del Pedregal,97616,68242,5178,171036
1650,"@unidadvenezuela Intervenci√≥n del BCV golpe√≥ mucho m√°s duro al d√≥lar paralelo que al oficial
 https://t.co/ppmd7zf1Pp",39818,86523,99342,225683
1651,¬øCu√°ndo alcanzar√° Venezuela la inmunidad de reba√±o contra el coronavirus? https://t.co/9heGIEsmfj  #NACIONALES,499,38973,35253,74725
1652,"Los Maestros tienen razones para votar el #21N por @AmericoDeGrazia  pr√≥ximo Gobernador Del Estado Bolivar y @cchancellor_f   Alcalde de Caroni, Maduro est√° raspado en Educaci√≥n.  La dirigente magisterial Carmelis Urbaneja pr√≥xima diputada plantea un cambio de modelo educativo https://t.co/wS9d3Ai0ii",44499,62969,87862,195330
1653,"#3Oct | Los cinco implicados en el femicidio de √Ångela Aguirre, adolescente de 16 a√±os asesinada el 23 de marzo de 2019 en #CiudadGuayana, estado #Bol√≠var, quedaron en libertad plena luego de que la Corte de Apelaciones del Tribunal Supremo de Justicia ratificara su decisi√≥n. https://t.co/RCy43WOjDi",4556,56752,94364,155672
1654,"Una #Noticia de este tipo nunca la ver√°s en @churuguara o en @espaciopublico ya que estos agentes de caos tienen como objetivo desestabilizar la poblaci√≥n partiendo del terror y la recepci√≥n de #Palangre pero que les quede claro: #NosotrosVenceremos

#AlTroteConMarcoTorres https://t.co/JEYSfGUAf6",76550,51532,8701,136783
1655,"@ZODI45_Carabobo @YormanMonteroD 3/3 los revolucionarios que estemos contribuyendo con la econom√≠a de la Rep√∫blica y no podemos aceptar que degraden los derechos del pueblo.
Hasta cuando siguen golpeando al pueblo y haciendo da√±o a la Revoluci√≥n de mi comandante Ch√°vez.
Se tiene que dar el ejemplo con las E/S",29551,9045,58795,97391
1656,"La #GNBFalc√≥n, prestan Seguridad a las instalaciones de las plantas El√©ctricas en todo el territorio Falconiano.
#31Mar  #FANB
#TodosContraElVirus
#GNByPuebloAlerta
#FANBEnDefensaDeLaDignidad 
.@NicolasMaduro 
.@cmdtegralgnb
.@GNBGDjuvenal
.@LopezvargasR https://t.co/1Q4f3ywzGV",81350,28967,78202,188519
1657,"No podemos seguir indiferentes ante la necesidad que viven nuestros ni√±os en #capacho creo que es hora de realmente ejercer la pol√≠tica del cielo en Venezuela.
#Venezuela #Tachira https://t.co/L1WGDzhTp7",22738,33006,28454,84198
1658,#14Abr Recibiendo los primeros 300 Chaguaramos para seguir poniendo a Coro Bonito de la mano de nuestro gobernador V√≠ctor Clark. ‚ù§Ô∏èüëäüèΩ @NicolasMaduro @dcabellor @PartidoPSUV @VTVcanal8 https://t.co/oPnf2leOwg,56594,7066,71109,134769
1659,#TENDENCIAS WhatsApp vuelve a pedir a sus usuarios aceptar las nuevas condiciones de uso a pocos d√≠as de la fecha l√≠mite https://t.co/fXN44ljQi0,24781,92048,88649,205478
1660,@BcodeVenezuela Buenas tardes cuando intento aperturar la cuenta a trav√©s de la aplicaci√≥n no me registra ning√∫n correo lo intento con varios y ninguno lo acepta,10716,75551,89741,176008
1661,@Banesco buenas noches el pago m√≥vil del banco dice que esta en mantenimiento,10950,80607,75659,167216
1662,@palmaf Y tiene mucho m√°s tiempo ca√≠da de lo que estuvo el BDV. Un desastre. Me da paja por los viejitos que tienen sus poquitos reales all√≠.,88419,38637,93921,220977
1663,"#ARC Tramo #Carabobo Tr√°nsito lento a nivel del Peaje de Guacara KM 140, que afecta la circulaci√≥n en ambos sentidos.",69270,73281,50477,193028
1664,"Viva la patria, hasta la victoria siempre paz a tu alma.",24715,19953,12020,56688
1665,"Hoy los sindicatos y gremios del Estado T√°chira, presentamos un documento ante el inspector del trabajo, para rechazar la violaci√≥n a los derechos laborales, contrataciones colectivas y la autonom√≠a funcional y administrativa de las Universidades, Gobernaci√≥n y alcald√≠as https://t.co/aDw3Vf7VV3",97307,82466,83375,263148
1666,#INTERNACIONALES Peruano abus√≥ de cinco adolescentes mientras les daba ‚Äúclases de religi√≥n‚Äù https://t.co/PIrMnxfXeL,86840,26808,3237,116885
1667,"#Privados de libertad 6 j√≥venes de La Victoria, Aragua, que realizaban jornadas de desinfecci√≥n contra #COVID19. 
El Tribunal  7mo de control les imput√≥ instigacion p√∫blica, agavillamiento, manejo indebido de sustancias peligrosas. V√≠a @churuguara https://t.co/W3rhthHj7J",84014,68258,19176,171448
1668,Me pasaron tantas cosas malas al hilo que ni pienso tuitearlas. Prefiero mirar un punto fijo de la pared hasta que se termine el d√≠a,12177,16894,55349,84420
1669,Que disculpas ni nada' porque no dicen lo que est√° pasando en verdad! HABLEN claro!,50947,48396,67759,167102
1670,#NACIONALES Guaid√≥: Finalmente es una realidad el acceso al Programa Mundial de Alimentos https://t.co/YTpGGZY6HR,109,93186,33166,126461
1671,EN CARABOBO: un rayo impact√≥ sobre dos j√≥venes dej√°ndolos heridos https://t.co/m1cYALC4QL,36540,18258,28457,83255
1672,"@PollaAGN Buenas tardes amigo yo puedo hacer un pago m√≥vil desde Banesco para el Mercantil, porque yo no tengo cuenta en ese banco",82039,54716,43744,180499
1673,Estado Bol√≠var: Un inspector fallecido y tres agentes heridos del Dgcim de El Callao tras¬†emboscada https://t.co/SaryrcmVAs,13082,66554,79020,158656
1674,"Disculpa pero ese libertinaje en Diciembre y en Carnavales ya ven√≠a  aumentando y te digo por Falc√≥n no informaban, en Chichiriviche  mandaban a los infectados a su casa a aislarse porque tienen pruebas r√°pidas y el √∫nico hospital est√° en Coro a 4 horas y copado dime es justo https://t.co/viZpOY9UbD",12916,97136,11813,121865
1675,"@gabriellopez80 Co√±o si.

Todo era tan brutal en aquella √©poca, de d√≠a y de noche m√°s a√∫n Adicora era el avant garde del estado.",40123,51017,38797,129937
1676,"üéôÔ∏èDeclaraciones de Jes√∫s Quintero:

‚ÄúMe sent√≠ muy bien por retornar como titular, me hac√≠a mucha falta jugar; estoy contento porque pude aportar al equipo‚Äù.

üìåV√≠a: Prensa Deportivo T√°chira FC https://t.co/ULIPc7sDLE",89395,47423,36422,173240
1677,"Pero lo lindo del f√∫tbol es que es impredecible y la sorpresa siempre est√° a la vuelta de la esquina, hoy luego de muchos a√±os logr√© jugar al Lado de una de las M√°ximas Figuras del f√∫tbol Venezolano @williamendezg 

Participamos en la Medios Champions League @sinergia897",44860,20501,55633,120994
1678,"Epa los de #Carabobo que saldr√°n en el Fraude electoral y creen en Bertucci üëâLa palabra es clara, ""No todo el que me dice Se√±or, Se√±or entrara al reino de los cielos"" Mateo: 7_ 21-23 #20Octubre #Venezuela  https://t.co/zS5UcHO2so",6144,49678,82484,138306
1679,T√°chira por 15 puntos vitales para buscar cupo¬†clasificatorio https://t.co/VFkIEpyvM8,66430,44691,37681,148802
1680,@Banesco @nativapagos Buenos d√≠as una pregunta yo tengo cuenta personal no puedo hacer una solicitud para un punto de venta gracias feliz d√≠a.,32570,99041,29822,161433
1681,@roserodriguez58 Bajo porque el gobierno inyect√≥ 50millones$ al BCV lo que ciertamente a posteriori seguro repercutara ojal√° que no pronto.,19255,24422,74342,118019
1682,si pueden decomisar ese arsenal  imag√≠nense que hay en las calles.,32613,8809,90692,132114
1683,#Diocesanas Di√≥cesis de Punto Fijo don√≥ medicamentos a hospital centinela Dr. Carlos Diez del Ciervo https://t.co/4Rz1uCc2nc https://t.co/kIqyKAzKiA,53583,54823,1032,109438
1684,@Banesco @nativapagos No puedo entrar a Banesco online que est√° pasando.,62845,63046,78078,203969
1685,"Y que pasara con las transferencias que se hicieron del banco de Venezuela a otros bancos? Yo hice una transferencia del Venezuela al bicentenario antes q se da√±ar√° la plataforma y esta es la fecha q no se ha echo efectiva, est√° descontada del banco pero no se ha echo efectiva al otro banco y mi pregunta es q pasar√° con eso?",69326,27761,73074,170161
1686,"@WingstopMexico En su sucursal pedregal es incre√≠ble lo poco capacitado y accesible del personal. Bueno, eso o nadie les dijo que estamos en pandemia üò∑...",28634,59042,23575,111251
1687,"#T√†chira 
Invitados cordialmente hoy a dejar sus donativos en los diferentes puntos , en solidaridad con #Tovar 
- Plaza los mangos
-Plaza Daniel Tinoco( Av. Carabobo)
- Obelisco. 
.

@AndinoAgro @JesusCardenas90 @lorearraiz @LaPrensaTachira @notitachirenses https://t.co/dedZDF3Qxo",27231,6036,3287,36554
1688,No s√© cuando co√±o es que podre sacar una TDD nunca hay disponibles en Cojedes.... ,91908,99027,7661,198596
1689,"#25Ago  #T√°chira #C√∫cuta #Emprendedores #Empresarios #Alquileres #Locales #Inmuebles #Inmobiliaria #Venezuela #Carabobo #Valencia  #M√©rida #Barinas 
Contacto: 04247375415 - WhatsApp https://t.co/Kt6d7RrsC1",92848,36091,54800,183739
1690,"@PetroDivisa @BcodeVenezuela @rmfinanzasve El Banco del Tesoro, tambi√©n nos tiene congelados los Bonos PDVSA y sus intereses desde 2018. As√≠ como lo depositado en cuentas corriente en divisas",45534,97091,89999,232624
1691,"#Vacun√≥metroVen | En Apure, Barinas y Falc√≥n es claro que la inyecci√≥n de la segunda dosis se est√° ejecutando fuera del periodo establecido. 

https://t.co/oJ6foSsXJ1",46698,70530,77923,195151
1692,"Desde hace tiempo esa gobernaci√≥n es ganada por la oposici√≥n estimado Andr√©s
Quisiera que le den un ojito a Carabobo para que vean la decepci√≥n https://t.co/8dcRVsQY88",35042,63748,73335,172125
1693,#INTERNACIONALES En S√£o Paulo exhuman tumbas antiguas para hacer espacio a entierros de fallecidos por covid-19 https://t.co/rfOPaxM1IN,65855,59472,60959,186286
1694,#SeVende Vivienda en Venta en Judibana de Amplios Espacios https://t.co/XbillD7gRL  #PuntoFijo  #Falcon,10796,28645,67493,106934
1695,@Virabhadra_1 ¬øY quedarse Sanchez sin su Falc√≥n? Su persona es incapaz de renunciar a la presidencia y a todos los privilegios que conlleva. En su vida se vuelve a ver en otra igual. Ni con agua hirviendo nos lo quitamos de encima üôÑü§¶üèª‚Äç‚ôÄÔ∏èü§¶üèª‚Äç‚ôÄÔ∏èü§¶üèª‚Äç‚ôÄÔ∏è,93133,86483,44748,224364
1696,"@carvareloso Sam Shephard de la original Panteras del T√°chira junto a James Rounthre( no me acuerdo c√≥mo se escribe el apellido), los verdugos de esa √©poca. Nadie pod√≠a con esa dupla",58645,79429,49988,188062
1697,"#Repost @rafaellacava10
...
Seguimos con el plan de rescate de los edificios en toda Carabobo. Hoy le toc√≥ a esta comunidad en el municipio Bejuma. Pilas porque el pr√≥ximo puede ser el tuyo. Aqu√≠ nadie se rinde. Q viva Carabobo ü¶áü¶áü¶á https://t.co/PIDSCCsddr",40807,72737,91162,204706
1698,"@luismarcanos @ConElMazoDando @dcabellor Yoooüôã
Desde Puerto piritu 
Mi @luismarcanos",13523,41339,37201,92063
1699,Un lugar llamado #Paraguana en #Venezuela https://t.co/Tpj1grGWzx,33751,80495,28586,142832
1700,"D√±a. Gloria Ni√±o de Cort√©s, mujer ejemplar del T√°chira, su aporte invalorable junto a su esposo, para mantener el diario de los tachirenses, @lanacionweb, su coraz√≥n lleno de nobleza y siempre una mano amiga y solidaria. A m√≠ amigo @fabioacortes y toda su flia. mis condolencias. https://t.co/83w6L7flkI",18190,96080,96790,211060
1701,CUMBIA PEDREGAL ‚ù§Ô∏è‚ù§Ô∏è‚ù§Ô∏è‚ù§Ô∏è‚ù§Ô∏è https://t.co/57ldZJDjrY,83790,75955,16551,176296
1702,"Dip. @sirit_eliezer: ""La decisi√≥n contra @ElNacionalWeb pretende cercenar el derecho a los venezolanos de estar informados objetiva y oportunamente"".",76678,59001,46347,182026
1703,Accidente en perif√©rico sur  direcci√≥n al norte pasando bulevar de la Luz jardines de pedregal @OVIALCDMX https://t.co/1ug9mT4kN0,72408,55487,55765,183660
1704,Falc√≥n y Gutierrez jugar√°n juntos por primera vez en el Supercl√°sico https://t.co/2urvl41S4o,62857,10141,86025,159023
1705,Trabajadores de la salud en T√°chira exigieron sus reivindicaciones laborables: ‚ÄúGanamos de 2 a 3 d√≥lares al mes‚Äù https://t.co/dq4QiP9IJ1,62002,50234,24633,136869
1706,"M√ÅXIMO COMPROMISO PATRIO! üëäüáªüá™ #17Oct üé• El MG Juvenal Fern√°ndez L√≥pez @GNBCmdtGral, realiz√≥ visita en el Comando de Zona @GNB41_CARABOBO acompa√±ado del Cmdte de Zona GB @Rivera_bastardo
#GNBPacDescanso
#LaVerdadSiempreTriunfa
#PuebloYCEOFANBVenceremos https://t.co/GfK48HWSxR",31928,86449,85017,203394
1707,"Venezuela üáªüá™  pide cambio y en el estado bolivar tenemos el hombre , el amigo y el gerente que necesitamos para empezar #PorElRescateDeBolivar Vamos todos en unidad üëç este 21N  con @Raulyusef1  gobernador. https://t.co/JcW5bwNfFb",4167,94648,94925,193740
1708,"@CorpoelecInfo Sin electricidad todo el sur este de Venezuela, desde Guasipati hasta Santa Elena de Uairen desde las 2:30pm el estado Bolivar, el estado que produce la electricidad de Venezuela, lo dejan sin el servicio a sus habitantes ademas sin gas ni gasolina desde hace meses",34393,20433,56464,111290
1709,Ministerio de Comercio exige denunciar a quienes no usen la tasa de cambio del BCV https://t.co/dXHU7JPCIW,12726,44702,33107,90535
1710,"57 colombianos residentes en Nueva Jersey y Pensilvania iniciaron el curso para emprendedores ""Aprende y Emprende"".  ‚úÖ
Organiza: Consulado de Colombia en Newark con el apoyo de Colombia Nos Une y CPC Global Group. https://t.co/9dBqJx6cxu",77604,7506,74925,160035
1711,"#EnVideo üìΩÔ∏è|| #FANB inspeccion√≥ centro de inmunizaci√≥n en la sede de la Fundaci√≥n del ni√±o ""Mundo Sonrisa"" del estado Bol√≠var.

#15Oct PuebloYCEOFANBPorVzla
#PuebloVencedor #GNBBol√≠var
#VacunarseDependeDeTi
#GNB2DADESURBOLIVAR 
.@libertad003
.@GNBCmdtGral
https://t.co/CgvmdPJQeO",39572,64528,38847,142947
1712,"@Banavihaldia Hola buen d√≠a, realizamos el pago del mes de agosto luego de la reconversi√≥n, ya les enviamos al correo se√±alado planilla y soporte y aun seguimos con la deuda, por los bancos no nos permite procesar, se realizo el pago directo desde Banesco, por favor",25276,29470,59461,114207
1713,Y ya se hab√≠a colocado la vacuna #SputnikV insisto vamos a cuidarnos #UsaCubrebocas #QuedateEnCasa https://t.co/fMDY4NaFCx,90044,27398,76567,194009
1714,"‚Ä¢‚ñ∫ @Pontifex_es La Iglesia en estos d√≠as entra en la gran meditaci√≥n de la Pasi√≥n del Se√±or. El Cristo sufriente est√° presente en el pobre, en el excluido, en el enfermo y en el hambriento, que llevan consigo el misterio de la Cruz. #SemanaSanta",68243,2346,42234,112823
1715,@sogora_12 @elpiojolopez @NOTIFALCON La iglesia tambien no colabora... el viaje de retiros antes de semana santa de la gente de la iglesia ...deben paralizar todo sino esto no va atener fin,7295,99537,53040,159872
1716,"Gasolina
- Subsidiada 0,00002180 PTR (Bs 5.000)
- Internacional 0,00890823 PTR (USD 0,50)

#03Sep #FelizViernes #Petro #Bitcoin",99861,91802,23185,214848
1717,"via TecnoAccesorio: Buenos d√≠as ¬°Feliz S√°bado!
Nuestra majestuosa Canaima, nuestro patrimonio y responsabilidad
¬°Hoy podremos con todo!
#FelizSabado #FelizDia #BuenosDias #TecnoAccesorio #Carabobo #SanDiego 
@sandiegovial https://t.co/Yvcd5NpiER #QuedateEnCasa",29570,81586,9033,120189
1718,@rmfinanzasve @BcodeVenezuela Paguenles bien le aseguro que no cobrar√°n m√°s de 50$ al mes,86232,42330,53921,182483
1719,Comisi√≥n de la Defensor√≠a delegada de Falc√≥n atendi√≥ solicitud de familiares de privados de libertad  y visit√≥ el centro de detenci√≥n preventiva subdelegaci√≥n del CICPC de Coro a los fines de constatar las condiciones de los internos y sostuvo reuni√≥n con autoridades del recinto. https://t.co/VWFTBT72r8,10003,179,86357,96539
1720,"Portuguesa dej√≥ pasar una oportunidad de oro para adue√±arse de la cima del Grupo Occidental al igualar 1x1 ante Hermanos Colmenarez
#LigaFutve
1. Estudiantes 35
2. Portuguesa 33
3. T√°chira 33
4. Zulia 22
5. Hermanos Col. 21
6. Zamora 17
7. Trujillanos 0 https://t.co/glITl6FnoZ",32328,91539,57026,180893
1721,#INTERNACIONALES Mujer que tosi√≥ en la cara de otra fue condenada a prisi√≥n https://t.co/dewIMbroSj,52445,79403,20167,152015
1722,"hacer nada de nada tipo nada pq realmente no quiero hacer algo, entonces quedarme mirando a un punto fijo sin pensar q tengo responsabilidades y un tiempo indicado 
I vote #everythingiwanted of @billieeilish
as #BestLyrics at #iHeartAwards https://t.co/aHVTbtvDc9",93468,94242,17150,204860
1723,@BcodeVenezuela Buen d√≠a hice un pago m√≥vil el s√°bado a las 7:30 am y me los descontaron y no callo al destinatario no tampoco me aparece en el hist√≥rico d operaciones que solucion me dan ustedes @BcodeVenezuela,11483,16565,88505,116553
1724,"VENEZUELA: BUSINESSMAN/NARCO KINGPIN (Emilio Enrique Mart√≠nez, aka: Chiche Smith, Paraguan√° Cartel) ARRESTED, LEAVES  https://t.co/1xIYB8xqPi",70399,20676,47695,138770
1725,"La #GNBFalc√≥n realiza despliegue de Seguridad, para el bienestar del pueblo en la lucha cont√° el COVID-19. #9Abr #FANB #GNB #GNBBol√≠var 
#BioseguridadPorLaVida
#GNByPuebloProtegido 
#YoSoyFANB
.@NicolasMaduro 
.@cmdtegralgnb
.@GNBGDjuvenal
.@LopezvargasR https://t.co/h4dj4t7h3T",14176,49632,80971,144779
1726,"Acaba de publicar una foto en San Juan De Col√≥n, Tachira, Venezuela https://t.co/KGN6SuhN4k",11879,48386,96739,157004
1727,"Estado Mayor de nuestra #FANB en el edo Bol√≠var, realiz√≥ inspecci√≥n al @D627_62 para verificar su Apresto Operacional

#14Oct #PuebloyCEOFANBEsPaz
#Soberan√≠aPatriayPaz
CentinelasPorLaPatria #GNBBol√≠var #GNB2daD623Bolivar
.@vladimirpadrino
https://t.co/rlLUuETmTW",74330,56378,57422,188130
1728,Juramentan Comando de Campa√±a Arist√≥bulo Izt√∫riz en Carabobo https://t.co/sJbh7Q9s39 https://t.co/E0mXUsHpfm,34992,17028,59706,111726
1729,"@bbcmundo Conozco Iquique. Las trabajadoras de recepci√≥n se nos ofrec√≠an por 30 $ la noche. Al chileno que vea en Vezuela lo mando al hospital a batazos de b√©isbol. En Puerto Ordaz, Estado Bolivar, Venezuela llegaron ingenieros mexicanos - chilenos y el urbanismo se llama chile-mex.",56907,53238,8809,118954
1730,Este taller estuvo dirigido al personal activo de la Contralor√≠a del estado Bol√≠var @CEBolivar001 a fin de motivar y generar un impacto en la visi√≥n de los funcionarios que les permitan alcanzar sus objetivos y mejorar el trabajo en equipo entre sus miembros. https://t.co/u6KhgTqEmW,48031,5624,9333,62988
1731,I always knew I was part garifuna because of my grandmother.  I found out today I‚Äôm a mix of garifuna &amp; Arawak.,27567,62062,59316,148945
1732,@Banesco @MarialeBelier Banesquin yo en las mismas! Perdi mi TD. Q hago?,85672,92158,6996,184826
1733,"REFRINSURCA - PUNTO FIJO  (  REFRIGERACI√ìN  INDUSTRIAL SURAMERICA  C.A  )  REPUESTOS DE REFRIGERACI√ìN  DOMESTICA,  COMERCIAL,  INDUSTRIAL, AUTOMOTRIZ. TUBER√çAS, GASES  REFRIGERANTES, ASESOR√çAS  E INSTALACIONES  DE  EQUIPOS  INDUSTRIALES  DE  REFRIGERACI√ìN, CALIDAD AL MEJOR PRECIO https://t.co/mZSyGIKRXe",10668,5669,80124,96461
1734,#15Oct üóûÔ∏è | BCV reduce la presi√≥n a los bancos por no vender a tiempo los d√≥lares inyectados https://t.co/6HKfKjpVjt,30986,16372,20361,67719
1735,"Valientes del ej√©rcito de batas blancas son ejemplo de solidaridad con pa√≠ses hermanos, salvando vidas en las comunidades. As√≠ lo demuestran los colaboradores pertenecientes al CDI Bol√≠var, estado #Monagas.

#CubaPorLaVida  #CubaCoopera #ACubaPonleCoraz√≥n #H√©roesDeLaSalud https://t.co/qAbj1DJAxk",12712,46544,55657,114913
1736,Alcald√≠a confirma 61 contagios y cinco fallecidos por Covid-19 en Carirubana https://t.co/Ug0iZ49CNM #Paraguan√° #Regionales #27Abr,6624,11506,57975,76105
1737,Daniel_RiosVE: Duermen en el piso: ni√±os vulnerables bajo tutela de un condado de California viven en condiciones deplorables https://t.co/gkq0uCJges #DanielRiosTeInforma #Valencia #Carabobo #Venezuela,8857,81400,87603,177860
1738,Los recog√≠an en transporte p√∫blico: Capturaron a sospechosos de tr√°fico infantil en Carabobo https://t.co/Mjvd5AiqmK,20349,3468,32147,55964
1739,@avilaelguerrero @Polic_carabobo @sundde_ve Pura paja,86999,93686,87468,268153
1740,Barrer las calles en busca de oro: el rebusque de algunas personas en el sur del estado Bol√≠var https://t.co/Q1r9FuXpgD,49416,66248,82343,198007
1741,"#Efem√©rides Desde el #7Sep De 1955 se celebra el D√≠a Internacional de los Derechos Civiles de las Mujeres fecha que permiti√≥ a las f√©minas mayores de 18 a√±os tener derecho al voto. #FANB
.@vladimirpadrino
.@dhernandezlarez
.@GNBCmdtGral
.@Redi_andes
.@ZODITACHIRA21
.@GNB_tachira https://t.co/77tsHlVZoz",90637,98591,37201,226429
1742,"Igualito sucede en Mariara edo Carabobo, 5 estaciones de gasolina y en todas es lo  mismo hasta cuando la bendita matraca por funcionarios y civiles tambi√©n, nadie hace nada.... https://t.co/iHbUGudrjB",14457,65761,62865,143083
1743,"Efectivos adscritos al #CVCDVC54CIJAA recuperaron en estado de abandono 325 Kg aprox. de material estrat√©gico (chatarra) en el mcpio. Bol√≠var Edo Anzoategui, #GNBCVC #FANB #CEOFANB  #GNBgarantezdepaz
@Zodimainor74 
@GNBCmdtGral 
@FernandezAlayon https://t.co/aBM0vzuAhh",45076,48952,21803,115831
1744,"@LaTeleTuya #LVBPXTLT 
Un saludo desde Naguanagua, Carabobo, los saluda cordialmente Jaime Ordo√±ez. excelente transmisi√≥n del juego magallanes vs Bravos. Hoy ganaran los navegantes. Saludos cordiales.",49058,67348,89523,205929
1745,"#ELECCIONES2021
El Secretario del Ayuntamiento de #Escuinapa se√±ala que la Mesa por la Paz y la Seguridad, que sesion√≥ hoy en el municipio, busca ‚Äúblindar‚Äù el proceso electoral del 6 de junio, tras denuncias de amenazas a brigadas del candidato Hugo Moreno https://t.co/lV0JnkBh6p",18134,8023,42264,68421
1746,"@BcodeVenezuela Quien le responde a uno el problema con ustedes? Nadie tiene las bolas de responder? Ladrones de mierda, devuelvanme mi dinero, un dinero que no gaste yo",99578,80583,98575,278736
1747,"Los q aspiran por la oposici√≥n sustituirlo en la gober no opinan; por eso andamos por estos medios. Es un exabrupto @rafaellacava10 q mientras Vargas y Falc√≥n cierran sus playas, usted ordena abrirlas. Adem√°s, Carabobo ha ocupado lugar N¬∞ 1 en contagiados.",61404,82967,23934,168305
1748,Gobierno de Carabobo inici√≥ fiscalizaci√≥n de precios en comercios https://t.co/dTCQ6IiM9L https://t.co/ChjQMWX1oy,42882,17958,90750,151590
1749,"23/08/2021. Plan Vacacional Escuelas Abiertas Agosto Bicentenario. Palabra de bienvenida a los presentes por parte de la directora del CEIS Santa Rita, preescolar el Carmen, Simoncito Comunitario Juan Germ√°n Roscio. Michelena Tachira. https://t.co/FAPkz0fo9U",30688,1754,28618,61060
1750,Ellos estan al lado del rectorado de la unefm.. hace mas de un mes la gente de la alcaldia y del rectorado los visitaron sin concretar alguna ayuda... comen gracias a la buena voluntad de algunos vecinos https://t.co/LFhoBQCEat,72406,34238,96969,203613
1751,"@EM_Petroboscan Lo peligros de la gasolina y el gasoil artesanal que producen en Falc√≥n
 https://t.co/0nvFCQ8DW8",59567,52876,84012,196455
1752,@kenin_nunez @liliamm_27 @PresidenciaCV 18.500.000 VENEZOLANOS necesitan informaci√≥n BOLSAS DE VALORES FINANCIERAS AGROPECUARIAS  @CNPCaracas @cnpven  @cnpzulia @Cnp_Lara  @CnpMiranda @CNP_Carabobo  @economia_gv @mmartinez_gv @sntpvenezuela @globovision @UNoticias https://t.co/w5uvVV2L0x,59484,67132,83793,210409
1753,@MarlindaOficial @SuperligaVen @TaurinosBBC @CentauroSLB Buenas tards. Le escribo para informarle y hacer d su conocimiento q la se√±al de @TVES_AlDia no se est√° emitiendo en el estado Falc√≥n d manera abierta (Canal 10).  Tiene mas d 14D OFF.  Este es un canal para el entretto del p√∫blico Coriano. Esperando corrijan y vuelva la se√±al,2312,6095,86746,95153
1754,"@laidygomezf las cuentas en dolares ya est√°n por el BDV, la √∫nica aislada es usted, a ver, comerciantes pagar√≠an impuestos en pesos y dolares???? obvio ah√≠ si lloran, esperemos que se te acabe esto el 21 de noviembre",38849,35382,80365,154596
1755,#NACIONALESCabello: Venezuela no acepta la presencia de grupos armados colombianos https://t.co/hsCFM5B9Ux,14421,45477,28939,88837
1756,#Carabobo Sindicalista de refiner√≠a El Palito Freddy Alvarado muere por COVID-19 #3Abr https://t.co/3yHYkvNg2o,14741,5494,16696,36931
1757,Se√±or presidente  la bolsa clap no deberia tardar tanto en  llegar  en  carabobo  las aguitas municipio los guayos llega cada  4 meses y las  proteina nunca an  llegado,19467,23633,98592,141692
1758,Familiares de detenidos en la Comunidad Penitenciaria de Coro piden que les dejen pasar comida y medicamentos https://t.co/8M0F4RsLsY,51392,51545,23986,126923
1759,@elgochoceballos @COOLCHANNELTV Muchacho pa gafo...,66699,67095,41068,174862
1760,"@LuisanaC16 Le basta al fiscal ir a cualquier bomba de gasolina y ver la trama corrupta de c√≥mo te venden la cola en $, o te pasan la la huella del punto haciendo ver q te cobran gasolina subsidiada pero te la cobran a precio de 0,5 d√≥lares o m√°s @MinpublicoVE @TarekWiliamSaab",1999,80115,15976,98090
1761,"‚õîPORTE IL√çCITO || Centinelas del  @GNB41_CARABOBO efectuar√≥n la aprehensi√≥n de un cddano a qui√©n se le incaut√≥ un arma de fuego A/O del @MinpublicoVE #GNBCaraboboSeguro #15Oct  PuebloYCEOFANBPorVzla
#VacunarseDependeDeTi
#PuebloVencedor  #GNBD411Carabobo 
.@libertad003 https://t.co/BYaBrowy4x",63749,7456,64002,135207
1762,"#ENT√âRATEüì£| El #28Oct inicia el XV Festival Mundial de Poes√≠a de Venezuela üáªüá™ que reunir√° a los 5 continentes en el grito libertario de #Carabobo a 199 a√±os del poema: Mi Delirio Sobre el Chimborazo, del Libertador Sim√≥n Bol√≠var 

#23Oct https://t.co/wGtwCvHM8E",72040,27495,45106,144641
1763,Acaba de publicar una foto en Paraguana - Pto Fijo - Edo Falc√≥n. https://t.co/Xckpy6AcXG,89978,4731,32014,126723
1764,"#CineForo 

Ligia Bol√≠var (@ligiabolivar): es muy f√°cil que frente a un cambio de gobierno, quienes hayan estado de un lado se cambien a otro. Hay quienes utilizan las v√≠ctimas como bandera y eso est√° pasando en este momento. https://t.co/cdazjzg04r",36869,94047,34664,165580
1765,‚ù§Ô∏èüá®üá∫ CDI Libertad Estado Tachira#Aniversario61FMC #ACubaPonleCoraz√≥n #CubaPorLaVida @cubacooperaven @FMC_Cuba @cubacooperaVTAC #MMedicaCubanaTachira https://t.co/ta9c8EhhNf,15829,73187,54493,143509
1766,"@NetUnoOficial @sundde_ve @Conatel @rafaellacava10 sres. NetUno ustedes no tienen que enviarme mensajes dando una fecha tope de pago, hasta que ustedes no resuelvan mi situaci√≥n del cobro excesivo no les voy a pagar. Abusadores! Cliente C.I. 17516643 San Diego Edo. Carabobo",74179,14102,16420,104701
1767,"#Carabobo | Estos son los centros de votaci√≥n para simulacro de elecciones en Carabobo | #7Oct

https://t.co/m6HKulMi30",9063,98009,60448,167520
1768,@HPUNICO @FabriziaMORETTI @ENZOSCARANO @JAVIERBERTUCCI Hermano si no se sientan perderemos todas las gobernaci√≥nes y alcald√≠as por ejemplo en Tachira le tienen que dar el apoyo a @laidygomezf quieran o no o el equipo de @jguaido quedar√≠a como promotores de divisi√≥n en Zulia se tienen que sentar con @manuelrosalesg,98935,79541,48151,226627
1769,"¬°Amemos al T√°chira! Inicia recolecci√≥n de desechos en municipios del eje metropolitano. Inform√≥ el diputado @FreddyBernal.

@NicolasMaduro @Silfredo_Z @Juntosxtachira1 @arguelloyepfri https://t.co/W3DLSAo403",36347,4079,35687,76113
1770,Adicora es vida. https://t.co/bUJDAqwJwc,63235,70868,17524,151627
1771,"#Ent√©rate || Sectores del Plan de Administraci√≥n de Carga #PAC que se aplicar√° este #13Septiembre, correspondiente al estado #T√°chira. 

¬°Te queremos mantener informado! https://t.co/gfnmtMbqPy",1918,37517,74015,113450
1772,"@TlalpanAl @CESACT @TlalpanVecinos @vecinoseguro @TlalpanCivico @TlalpanConscien @TlalpanCoyoacan Todo Tlalpan  desde la calle desde comenzando pedregal de San Nicolas primera secci√≥n, hasta m√°s all√° de milpas y con colonias que no tienen como comunicarse",81325,86067,44755,212147
1773,¬øIgual hay que ir al banco? Ni entiendo la noticia,73960,97985,7422,179367
1774,"@atameAti @saltillotwit EST√ÄS EN LO CORRECTO. Solo que a los morenistas en su mayor√¨a los encuerdan con encuestas donde van arriba y lo de siempre.... a echarse a la hamaca. Y ya perdidos, las lamentaciones.
#Morena #AMLO #Mariodelgado #CDMX #Mexico #Coahuila #Saltillo #Monclova #Acu√±a #Piedrasnegras",1950,42935,5461,50346
1775,Aqu√≠ seguimos cumpli√©ndole a nuestro pueblo sin parar un segundo. Aqu√≠ nadie se rinde. Q viva Carabobo ü¶áü¶áü¶á https://t.co/7OK1GWbo96,70427,83626,40742,194795
1776,"Hp bancooooooo nojodaaaaaaaaa .. todos los dem√°s bancos abren , transfieren y dem√°s y el hp banco este nooooooooo .. Dios santo necesito comprarrrrrrrrrr",99596,3267,61147,164010
1777,"@SSPCMexico @OVIALCDMX @UCS_GCDMX @SSC_CDMX paseos del pedregal 605 se tiene que caminar por debajo de las banquetas, esto es todos los d√≠as, aunque tienen una c√°mara arriba de ellos, ser√° negocio de alg√∫n funcionario? https://t.co/qufZX6BM34",53289,62703,5636,121628
1778,"Es que se dieron por enterado que el dolar va a escasear a nivel mundial y ya no aumenta a diario, cogieron otra vez para el bolivar para justificar aumento de producto por cualquier otra razon que no es el precio del dolar..A los especuladores no les gusta mucho la tasa del BCV. https://t.co/8JugO3cWYS",12981,24257,78360,115598
1779,"‚öñ ¬øBusca una Notar√≠a de confianza, r√°pida y eficaz? 
Notar√≠a Trece, perm√≠tanos ser su aliado legal de confianza. ‚úí
Morelos 504 Sur Centro, PiedrasNegras, Coah.
Tels. (878)782-2844 / 01-800-507-3266 https://t.co/lerVvlIJWp",68236,81411,5631,155278
1780,"@UnidadGremial S√≠ claro,Andr√©s Vel√°squez en Bol√≠var,gan√≥ se organiz√≥ con todo su padr√≥n electoral,tuvo representaci√≥n en todas las mesas,hasta el √∫ltimo rinc√≥n del Estado,logr√≥ tener todas las actas en sus manos,con las mismas,pudo demostrar el robo obseno,q le hizo el CNE,NO VOTO M√ÅS ‚ÄºÔ∏èüÜò",79065,67657,88434,235156
1781,"¬°Pueblo de #T√°chira seguimos recuperando las v√≠as de #SanCrist√≥bal! En la Av. Antonio Jos√© de Sucre estamos sustituyendo la capa del manto asf√°ltico que ten√≠a m√°s de un a√±o sin un cari√±ito, donde aplicaremos 1600 toneladas de asfalto desde la Redoma del Avi√≥n hasta Venetubos. https://t.co/lTspC3KbwA",92306,78565,17376,188247
1782,#SUCESOS Fiscal general confirm√≥ la detenci√≥n de ‚ÄúChiche Smith‚Äù en Anzo√°tegui https://t.co/QJ8Mpx6QjA,76643,43442,38194,158279
1783,@MarioSanchezVe @DvoTachira Hasta cuando seguiremos los del Tachira sufriendo a Valera :-(,43975,64881,36876,145732
1784,"@ruxire Daka vende muy caro para cosas que se ve tan baratas, osea de baja calidad, mejor vete al Sambil, en Carabobo conozco sitios mejores, en otros estados no tengo idea",98001,88216,64719,250936
1785,@pedroluisflores Yo no üòí  Estado Falc√≥n full Lluvia y Frio y Coro d√≥nde de ha vistoü§∑,70693,22198,99208,192099
1786,"#30Mar #Falc√≥n #Sucesos #Coro Vend√≠an bicicletas hurtadas y les cay√≥ Polimiranda
https://t.co/Oy5jDxkQC9 https://t.co/I2Y4JdykUK",36226,43911,84660,164797
1787,"‚ÄúHemos estrechado lazos a trav√©s de la Asociaci√≥n de Ganaderos del estado T√°chira y por ello, ratifico que estamos dispuestos a trabajar mancomunadamente y seguir en las mesas de trabajo con el futuro gobernador del estado T√°chira‚Äù, puntualiz√≥ Maldonado.
#AmemosAlTachira
#Tachira https://t.co/f7KoDbcKxQ",44354,46414,45367,136135
1788,@NicolasMaduro  @onapre_oficial @onapre_oficial Los Trabajadores de Corposalud adscrito a la Gobernaci√≥n del Estado Tachira solicitamos la aprobaci√≥n de los recursos de la Homologaci√≥n de los meses de Mayo Junio y julio del a√±o 2021,25095,27645,97634,150374
1789,"Acaba de publicar una foto en Santa Ana De Coro, Falcon, Venezuela https://t.co/Rm26hztb2Y",85865,18669,36226,140760
1790,Encuentran dos cabezas humanas en una plaza del estado Bol√≠var https://t.co/iAI41TOYUe  #SUCESOS,96090,1975,79621,177686
1791,"Saludos desde punto fijo viendo TLT los cardenales de San Luis es un equipo que poco chance le ha dado a los venezolanos en su historia recuerdo muy pocos Ordaz, Roger cede√±o y el √∫ltimo creo que Edward Mujica en 2013 #MLBxTLT",29698,11363,38140,79201
1792,"#PronosticoDelClima  üå¶Ô∏è

En la imagen se observan √°reas nubladas con descargas el√©ctricas (destellos azules) en √°reas del Zulia, T√°chira, Falc√≥n, Sucre, Monagas, Delta Amacuro, Apure, Bol√≠var y Amazonas. Hora: 04:30 HLV. V√≠a @INAMEH @luiscarrillo66 

#CaminosDeVictorias https://t.co/Y385dPOMec",88377,62264,35320,185961
1793,@Banesco Y si cambio mis bs a $ por la mesa de cambio puedo retirar efectivo en sus agencias?,56302,76804,19873,152979
1794,"üö© DEMANDA DE TALENTO 
.
.
.
‚úåüèºEl √©xito es la suma de peque√±os esfuerzo repetidos d√≠a tras d√≠a.
.
.
.
#gri #grivenezuela #demandadetalento #vacantes #empleos #trabajos #empresas #gestionhumana #rrhh #reclutamiento #selecciondepersonal #valencia #carabobo #caracas #venezuelaüáªüá™ https://t.co/s0j0e0Vdg1",83309,82826,95737,261872
1795,"1-Que alguien me explique. Este sr esta aspirando a la alcald√≠a de Guasimos edo. T√°chira. Y x wsp me invita a votar ma√±ana en unas primarias para ser candidato. Cuando le dije q en tiran√≠a solo votan los politiqueros cohabitadores, me responde. Q el no es pol√≠tico y busca cambiar https://t.co/4ODgrB4k6E",88844,9516,57288,155648
1796,"@BcodeVenezuela Buen d√≠a, por que solo aparece el dinero del punto de venta del jueves y lo de ayer? @BcodeVenezuela",33419,33757,55467,122643
1797,"Ellos controlan PDVSA, El BCV y los medios de comunicaci√≥n, ¬øPero la culpa siempre es del imperio, DolarToday, o Maria Corina? ¬øTu realmente crees que DolarToday controla la econom√≠a de todo un pa√≠s desde un app? ¬øen serio? https://t.co/cAHupFL8Ic",54183,53808,66835,174826
1798,@FreddyBernal Tenemos fe en Dios y en usted camarada y combatiente Freddy Bernal que el T√°chira va ser el Estado mejor econ√≥mico del pa√≠s amemos al T√°chira üòéüëçüíØ,38859,27909,13816,80584
1799,@JP_7_ Los Andes siempre tienen ese Encanto T√°chira y Merida son lo Mejor de Venezuela Aguante P√©rez Jim√©nez,58636,58893,76038,193567
1800,Marc Anthony se disculpa por no ofrecer concierto debido a falla t√©cnica https://t.co/tTXmY1Dko7,73077,16152,67541,156770
1801,@RCR750 @churuguara Pais bizarro.  Cuando se ir√°n a arrechar y terminar con este narco r√©gimen y sus colaboracionistas?,44395,99895,59419,203709
1802,"#09Abr #Falc√≥n #Coro | Entre un 15 y 20% ha bajado la venta de pan 
https://t.co/xyE1Q4jhQM https://t.co/5L7Mi5hT9a",41798,58336,65066,165200
1803,La imposici√≥n del dolar cucute√±o y la rapi√±a de comerciantes agrupados en @fedecamaras y otras organizaciones. No paran orden del Estado respecto a cual es el referente aplicarse a partir de la entrada del nvo cu√±o monetario. @NicolasMaduro @delcyrodriguezv @BCV_ORG_VE @VTVcanal8 https://t.co/JkxL5Gh17M https://t.co/uniLZsd3vZ,50944,3550,6533,61027
1804,Otro objetivo logrado.... constancia y disiplina en San Cristobal - Edo Tachira https://t.co/aGoQLJ8Rh5,54063,96537,72782,223382
1805,"15'. ¬°Cerca las locales!

Tiro por alto desde el sector derecho a segundo palo, donde Jacky Garc√≠a se lanza a lo ""Manuel Negrete"" en M√©xico '86, pero su disparo llega hasta El Pedregal.

¬°Vamos para adelante, Academia!

#LaFielFemenil",74306,49751,51471,175528
1806,Presos por vender bicicletas hurtadas de un comercio en Coro https://t.co/8phF4OXAVA #SUCESOS,92649,49714,39920,182283
1807,@maigongh @Banesco cada vez que intento hacer un pago movil por la pagina https://t.co/4LhInvv6hP,61683,75034,63761,200478
1808,"A PASO DE VENCEDORES! NUESTRA PATRIA AHORA MAS QUE NUNCA LIBRE! La #MiliciaBolivariana Presta, Preparada, Entrenada y Organizada. @ZODI45_Carabobo @cmmzodic @libertad003  @NicolasMaduro  @vladimirpadrino @dhernandezlarez 
#VivaLaPatia https://t.co/L3eZsjxDX8",11434,24069,29987,65490
1809,@Lamaestra09 @Banesco Saludos. ¬øEst√° intentando entrar desde Cantv?,82937,25301,74792,183030
1810,O sea que se robo esa plata tambien? Mucha rata!Primera L√≠nea: Gustavo Bol√≠var se defiende ante el Consejo de Estado | RCN Radio https://t.co/6auq27hdvY,50298,40370,77433,168101
1811,"El Metro de Caracas tambi√©n presenta falla en su servicio.

La se√±al y conexi√≥n a internet, es escueta.

Zonas de Aragua, Carabobo, Miranda, Lara, T√°chira, Nueva Esparta y Zulia, tambi√©n est√°n afectadas.

Corpoelec, no se ha pronunciado.

#Venezuela",40720,16966,71294,128980
1812,"@luis_villegasr @delcyrodriguezv @Mippcivzla @BCV_ORG_VE @JuventudPSUV @nicmaduroguerra @VTVcanal8 @EneidaLayaPsuv @UNoticias @d_guzmanl @almacaracas Bienvenida la moneda, esperemos que el aumento del dolar, dos veces al d√≠a de lunes a viernes de todas las semanas del a√±o permanezca estable, de lo contrario, es esa moneda especulativa la que continuar√° regulando la econom√≠a del Pa√≠s y el estado sin dar pie con bola para frenar",29761,36554,95729,162044
1813,#MiliciaBolivariana m√°s que un compromiso patrio siempre estaremos rodilla en tierra #PieDeLucha @wistohor @dhernandezlarez @vladimirpadrino @ADI_Tacarigua @ZODI45_Carabobo @REDICentral_ @AmeliachPSUV https://t.co/wBkPsrTUSS,29648,45919,86464,162031
1814,"üö®üî•‚õΩ  Reportan un incendio en uno de los tanques de la Refiner√≠a El Palito, en #Carabobo
Reportan incendio en uno de los tanques de la Refiner√≠a El Palito, aparentemente, luego de que cayera un rayo. Bomberos, PDVSA y Pequiven tendr√≠an la situaci√≥n controlada, -@Alertas24Vzla https://t.co/6rvtpB4SQn",19224,33225,20857,73306
1815,"Carson - H√©ritier

Je vous conseille fortement d'aller √©coutez les deux Volumes de Falconia dispo sur toutes les plate-formes üî• 

https://t.co/xEf8LOXQsR https://t.co/ChnjaFW6pL",89637,1194,63625,154456
1816,"As√≠ como los laboratorios Q se construir√≠an en unos terrenos ubicados entre el complejo petroqu√≠mico ""Jose Antonio Anzo√°tegui"" y puerto Piritu en Anzo√°tegui? Cuyos laboratorios eran principalmente Pfizer y Bayer, Si mal no recuerdo Creo que fu√© en la gesti√≥n De TareckWilliamSaab https://t.co/QF0EoMwPlt",16598,29764,25918,72280
1817,"#Atenci√≥n | El Consulado de Colombia realizar√° una jornada de  #ConsuladoM√≥vil en Tampa üá∫üá∏ el pr√≥ximo 28 de agosto. 

Programe su cita üëá 
https://t.co/FS5XYT7q94 https://t.co/X6m2SSqOa9",24505,94114,84612,203231
1818,"#MLBxTLT  Saludos desde cordero estado tachira, mis 3 son:

Shohei Ohtani!
Gerrit Cole!
Lance Lynn!",89258,63594,62171,215023
1819,"DIRECTORIO M√âDICO CARABOBO
MES DE SEPTIEMBRE
#Salud #Clinicas #Guarico #Trujillo #Miranda #Monagas #Bolivar #Tachira #Cojedes #Aragua #Zulia #Caracas #Apure #Falc√≥n #Carabobo #NuevaEsparta #Barinas #Anzoategui #Merida #Portuguesa #Venezuela #Carabobonet
https://t.co/xM82YvRFVB",90678,97947,19234,207859
1820,@cmmzodic @NicolasMaduro @ZODI45_Carabobo @dhernandezlarez @wistohor SI PORQUE LA MILICIA NO SE CANSA Y SIEMPRE ESTAMOS PRESTO A CUALQUIER ORDEN EMANADA DE LA COMANDANCIA GENERAL PARA CUMPLIRLA YA QUE LOS ESCUDO BOLIVARIANOS HAN SIDO UN GRAN EXITO,42898,72122,9963,124983
1821,"¬°Una #nueva #serie de #ciencia ficci√≥n de @AlanSomoza!
Con olor a #Mandalorian o a #Firefly, una #aventura #espacial de corsarios que buscan prosperar en una galaxia despidada e indiferente.¬°Conoce la #historia de Kiara Dreston!
https://t.co/B7G5dX6Wr8

#Espa√±a #Mexico https://t.co/nKL7zis735",95460,51853,94876,242189
1822,"@AreaZamora
@apdi_candelaria 
@NicolasMaduro 
@vladimirpadrino 
@dhernandezlarez 
@libertad003 
#MiliciaBolivariana 
#PieDeLucha 
'La MUJER. preparada
Que Proyecta Su Imagen
C√≥mo Pol√≠tica  Gerencista, Militar. Esa
Es la Mujer, Luchadora"" https://t.co/fmwd8zUFNP",37323,31355,90535,159213
1823,"@ReporteYa @CarlosOAlbornoz En la Falcon-Zulia, caserios cercanos a Coro, tambi√©n sucede regularmente y desde hace bastante pero, bastantes a√±os, desde el Montillismo se da eso, se hacen colas de carros interminables y tranca hasta m√°s de 12 horas, y el gobierno regional y municipales bien gracias",91292,86645,26157,204094
1824,"CDI Diego Salazar P√≠ritu realizando encuentro con miembros de la direcci√≥n nacional y del Estado y a su vez haciendo entrega del diploma de fin de misi√≥n a colaboradores por el deber cumplido. 
#BarrioAdentro18Aniversario #CubaPorLaVida #CubaCoopera https://t.co/tNmnJ9EhWJ",3818,6029,4616,14463
1825,@elgochoceballos https://t.co/Qu5akL0Idw,26842,90180,29807,146829
1826,@Banesco y entonces...? Desde ayer en lo mismo. https://t.co/IiOKZM2SbI,13819,13070,77514,104403
1827,"#ATENCI√ìN  ||  Conozca el tipo de cambio referencial que refleja el #BCV este #Martes #26Octubre del 2.021.

#FelizMartesATodos
#NoMasXenofobia
#QuedateEnCasa
#BolivarDigital
#Venezuela

#VacunateSinCita
#PatriaSoberana 
#26Oct
#AlexSaab
#MercadoCambiario 
#BCV
##DigamosPresente https://t.co/1MScxAcRDt",5290,33940,78978,118208
1828,Isabel Sofia pero no me da opci√≥n de tarjeta de d√©bito dice otras menos d√©bito no se como hacer ,67850,17062,85995,170907
1829,"#Atenci√≥n üáªüá™ | Durante el despliegue del Plan Operativo Conjunto de Fiscalizaci√≥n, los funcionarios de @mincomerciove, ajustan a detalle la nueva implementaci√≥n de la Nueva expresi√≥n monetaria y la tasa fijada por el @BCV_ORG_VE  en la Candela, Distrito Capital
#Vacunaci√≥nAbierta https://t.co/vfhjR30V6Y",78198,50510,8879,137587
1830,"Bendiciones a su madre, Dios y la virgen le den salud y vida, felicidades",5603,17042,12703,35348
1831,"@juditvalderrama Ah√≠ jugu√© hasta que me supo. Luego trotaba o iba a ratos. Es m√°s cuando estaba chamo que ca√≠ de un √°rbol cerca del Metro, baj√°ndole una cometa a otro chamito, la gracia me cost√≥ algunas costillas rotas y me se me sali√≥ la clav√≠cula derecha. Los gobernantes no quieren al T√°chira.",69455,82209,23846,175510
1832,Ajajajaj ataque cyber terrorista del imperio,53058,24720,56967,134745
1833,"Ent√©rate| Esta es la ubicaci√≥n de los 90 casos de #Falcon reflejados en el balance del 7 de abril suministrado por la @Salud_Falcon

#urumaco y #zamora, entre los municipios con m√°s nuevos contagios luego de #miranda y #carirubana #8Abril https://t.co/jcXVpPxBPi",81330,65546,12018,158894
1834,"@gmartin1961 Los edificios quemados en el T√°chira han sido dejados as√≠ como testimonio que ellos si pueden destruir evidencias y todo queda impune, ejem oficinas de la Contralor√≠a, oficinas de Corpoelec, Cotatur, entrada universidad de la Unefa",22751,29608,29574,81933
1835,"Jueves santo, de guardia.

Es para que m√°s bien estuviera en las salinas de las cumaraguas con una caja de Zulia y comiendo pescado frito.",88072,78435,94603,261110
1836,"@chavistaganadr @Karimg40 Hoy vi con dolor el deterioro tan grande en la estaci√≥n parque Carabobo, la desidia el and√©n inundado, los vendedores de golosinas, y los q comprar el d√≥lar a 4,5 no hay una autoridad q haga cumplir las reglas üòî q tristeza no avanzamos",77442,70431,65782,213655
1837,"@cubacooperaVE_D @cubacooperaven @GHNordelo5 Nuestro CDI Sim√≥n Bol√≠var, Municipio Casacoima, Estado Delta Amacuro, apoyando y festejando el 61 Aniversario de los CDR.",26757,98389,7589,132735
1838,"La GNB mantiene su compromiso de velar por el bienestar y seguridad en los ejes viales del estado Bol√≠var. 

#16Oct #JuntosSomosM√°s
#VenezuelaTieneConQu√© #GNBBol√≠var
JuntosPuebloyGNBInvictos 
.@PresidencialVen
.@PrensaCmdteGral
#GNBDCR62_4Bol√≠var
 https://t.co/UtIUqXw4jy",64650,35691,58426,158767
1839,Fue asesinado por cuatro sujetos que ingresaron a  su  casa en Carabobo https://t.co/xRvBiT6q5b,43442,41024,88343,172809
1840,"Buenos d√≠as @iskil te deseo un Fabuloso d√≠a. Somos Hij@s de Bol√≠var y Ch√°vez; Nuestra labor tiene un prop√≥sito m√°s elevado, su fin es conservar nuestro Legado y consolidar la Patria Grande en un Estado de igualdad en la Diversidad

Nosotros Seguiremos Venciendo por Siempre https://t.co/mhMB3bfSC9",17540,19246,90791,127577
1841,"#AlfayaracuyDivisas 
Precio de divisas al 21 de octubre 7 pm
D√≥lar BCV: 4,21
D√≥lar paralelo: 4,33
Euro: 4,90
Petro: 235,22
https://t.co/lp2iRNrxhJ 
https://t.co/ajdwEqpNvt
---------------------------------------------",77070,8893,96973,182936
1842,"@NathalyMC_ @JAVIERBERTUCCI As√≠ debe ser, Carabobo y Venezuela necesitan retomar los verdaderos valores y principios para lograr una mejor sociedad",99352,47150,14263,160765
1843,"justificaci√≥n se refiere a un fin que se encuentra en el futuro"" (Hannah Arendt). Por eso la legitimidad de la Naci√≥n proviene del 11J-1811 as√≠ como P√©rez Jim√©nez celebraba los 2D, la democracia se asent√≥ en el 23E y el Pacto de Punto Fijo y el chavismo celebra los 4F.",60598,87655,11063,159316
1844,Paraguan√° la mejor tierra del mundo... https://t.co/TtQ0WTWrOs,6687,75956,83747,166390
1845,#NACIONALES Guaid√≥: El chavismo ha tenido que reconocer el n√∫mero m√°s alto de contagios https://t.co/eLEoR1q5lz,92314,67957,45234,205505
1846,Yover Peinado eso lo puedes hacer por tu mismo usuario yo le aperture cuenta a mi hermana y le solicite la tarjeta ,75239,1099,57613,133951
1847,@rmfinanzasve @BcodeVenezuela Se√±or Roman Maniglia las cuentas del banco de venezurla estan expresando saldos negativos que aparecen de la nada cuando daran respuesta? Su servicio de reclamos no funciona,87466,16793,58220,162479
1848,Hallan cuerpo calcinado cerca de la finca de Alex Cabrera https://t.co/GXb6XUUz3w  #SUCESOS,55623,59804,32766,148193
1849,"#GNBFalc√≥n, prestan Seguridad a las instalaciones de las plantas El√©ctricas en todo el territorio Falconiano.
#30Mar #FANB
#SputnikVContraCovid
#GNByPuebloEnVictoria
#FANBEnDefensaDeLaDignidad 
.@NicolasMaduro 
.@cmdtegralgnb
.@GNBGDjuvenal
.@LopezvargasR
https://t.co/lHj60T7PM7",21709,32350,24419,78478
1850,"@Banesco Hoy quiz√°s est√© operativo, pero anoche no serv√≠a para un carajo, tarde 2 horas para entrar y 1 para hacer una transferencia.
Y no era mi internet. El problema era de uds.",39208,13792,12596,65596
1851,#MiliciaBolivariana por amor a la patria de Nuestros ancestros Bol√≠var y Ch√°vez #PieDeLucha por la defensa desde cada rinc√≥n  #HistoriaDeLaMiliciaBolivariana @wistohor @hljohan @libertad003 @vladimirpadrino @PrensaFANB @ADI_Tacarigua @ZODI45_Carabobo https://t.co/YxN6ka2Tth,14651,54877,74439,143967
1852,"@avilaelguerrero @SARUMAN1 @rafaellacava10 @Polic_carabobo @el_carabobeno Yo sab√≠a que Lacava les iba a meter la mano, ahora digo yo d√≥nde co√±o est√° el consejo comunal las ubch y todo lo dem√°s no articulan se lo dejan todo al poder central...",85315,47687,97098,230100
1853,"e esperamos en Abasto y frigor√≠fico EDYMAR. La mejor atenci√≥n, calidad y excelentes precios. Direcci√≥n: Av. Principal del Barrio Las Flores, a 2 cuadras de la E/ S PDV - Unidad Vecinal #sancristobalvenezuela #sancristobaltachira #tachira #carniceria #carnes #carniceriagourmet https://t.co/UCKa71lpGm",72934,68533,85952,227419
1854,"@LecheriaEnAcc Base Cooler para Mini Laptop de Aluminio con 2 Fan con Cable USB M/M para la conexi√≥n, 6$. Hacemos env√≠os nacionales #Cooler #Laptop #USB #Vende #TecnoAccesorio #Carabobo #Valencia #SanDiego #mercadolibre https://t.co/0yV832TgIE https://t.co/9y0LBHYPlP",43348,17397,6316,67061
1855,@tomasealfaro naci√≥ en clarines y se cri√≥ en pto piritu,79202,15873,88390,183465
1856,"D√≠a y noche, Centinelas de la #GNBFalc√≥n se mantienen comprometidos en garantizar el Bienestar de nuestro pueblo. 
#3Abr #FANB
#SputnikVGarantizaVida
#GNBGaranteDePaz 
#FANBEnDefensaDeLaDignidad
.@NicolasMaduro 
.@cmdtegralgnb
.@LopezvargasR
.@GNBGDjuvenal https://t.co/YbHfyYnjc4",454,39660,91005,131119
1857,"Mes Aniversario PTMS Urumaco 
@NicolasMaduro 
@MPPEDUCACION 
@psuvaristobulo 
@RosangelaOrozco 
@Nancyor7 
@jorgepererezVzla
@MarelysCastro21 
#FalconProduce
#PTMSFalcon 
#FalconEsEfucacionProductiva
#cadafamiliaUnaEscuela https://t.co/upAwiJkzZx",41246,79332,14484,135062
1858,@CarnetDLaPatria @NicolasMaduro Presidente aqu√≠ en Falc√≥n espec√≠ficamente en Punto Fijo las bolsas solo traen Pasta y Arroz los dem√°s no lo trae,32643,88609,46102,167354
1859,Y cuando ser√° que la cuerda de ineptos que trabajan ah√≠ arreglaran el problema??? 4 d√≠as en este Y no quieren que la gente se arrech3? ,15802,61299,87047,164148
1860,"üò∑Cuidar del pueblo es nuestro m√°ximo compromiso en el municipio Bejuma,Edo #Carabobo garantizando el cumplimiento de las medidas de bioseguridad! #GNBGDP
#GNBGDP1CIAELPARAISO
#24Oct #VacunarseEsVida
#CEOFANBInvictosPorVzla
@PrensaCmdteGral
@somos_ejercito https://t.co/q73rOTMbxS",9106,1880,25629,36615
1861,"@ZODI45_Carabobo Siempre ser√° imporante la participaci√≥n militar en los asuntos politicos, ya que como son de gran envergardura estos temas, hay que mantener el orden. No sentimos opresion el d√≠a del simulacro electoral.",68206,92937,85947,247090
1862,Fotograf√≠a de Pedro Antonuccio San√≥ #street #urban #sancrist√≥bal #estadot√°chira #t√°chira #venezuela 2008 #urbanphotography city #cityphotography #streetphotography #architecture #architecturephotography #street #streetphoto #fotocalle #murales #muralesart https://t.co/GLF0Likvg6,49672,16805,15529,82006
1863,"Comprometidos con el bienestar de nuestra fauna dom√©stica. Unidades policiales, tras recorrido preventivo, rescataron a un can que se encontraba a un costado de la v√≠a, herido por un posible atropello, en Pedregal, provincia de Chiriqu√≠. Fue llevado para atenci√≥n veterinaria. https://t.co/XFMBFywW82",33526,15457,75589,124572
1864,@Banesco ??? Ser√° confiable y no es un robo de datos?,74300,7096,60210,141606
1865,#29Mar La gente quiere ayudar y quiere poder aportar a la lucha es mentira q bajaron los brazos. En mi opinion hace falta una direccion y unidad de proposito clara para que se d√© el inherente y obvio neo pacto de punto fijo para derrocar el momento autocratico q padece Venezuela.,10329,74194,61577,146100
1866,Como cuando tienes tantas cosas q hacer que te quedas mirando en punto fijo a la pared porque no sabes por cual empezar? Po esa es mi vida ahora.,39128,46255,8298,93681
1867,@Digitel_Info412  claramente se ve lo p√©simo de la se√±al en mor√≥n estado Carabobo no sirve digitel https://t.co/2CIYar3973,70974,93427,25694,190095
1868,"üõëFieles y comprometidos con el Pueblo Venezolano, en #Aragua y #Carabobo permanece la @GNBunidad_vial desplegada en la #ARC para garantizar Seguridad y Auxilio Vial a todos los Usuarios de tan Importante Arteria Vial.

#GNB #14Oct #FANB 
#GNByPuebloInvictos 
#Soberan√≠aPatriaYPaz https://t.co/DKKW8RZO8e",60034,10116,15562,85712
1869,"V√≠a @ReverolNestor 

Desde el coraz√≥n energ√©tico de la patria, nuestro Complejo Hidroel√©ctrico del Bajo Caron√≠ en el estado Bol√≠var, continuamos con el despliegue nacional de la #VicepresidenciaDeServicios https://t.co/CVmCFkzfy3",73616,46183,23543,143342
1870,BCV de Maduro introdujo 50 millones de d√≥lares al mercado cambiario para aguantar al ‚Äúparalelo‚Äù - https://t.co/TqPcf6BRGS https://t.co/eMpJA8C7Yp,64212,7897,90648,162757
1871,Gooool del maldito lisiado de Pedregal,97539,45508,36122,179169
1872,"Nuevo apag√≥n general en T√°chira, M√©rida y Trujillo  https://t.co/7KAFs5Qmmr",8983,10673,97803,117459
1873,Acaba de publicar una foto en Museo del T√°chira https://t.co/ASYenRo0U5,42585,59930,89439,191954
1874,"No me interesas est√°s muy viejo y eres malo ‚Äú yo soy casi una Reyna y no tenia ning√∫n inter√©s santamente que no perteneciera a Dios ‚Äú t√∫ eres malo y nos hiciste mal y trataste de humillarme, como si yo tuviera vanidad y me quisiste undir en la pobreza y abusos ‚Äú soy indiferente",35113,83675,49832,168620
1875,Te prometo que si ese d√≠a hay luz todos salimos a votar pero como ahora Carabobo es territorio de la oscuridad no te prometo nada üëé https://t.co/RfTPMES2S9,1225,70961,79760,151946
1876,"@LaTeleTuya  desde san Juan de col√≥n tachira , saludos amigos , miguel hoy llega y cuando lo pegue se vendr√° el segundo y se quitar√° la precion",8954,7877,38636,55467
1877,"BCV actualiza tasa del d√≥lar oficial este #21Oct (+Monitor)
https://t.co/SFEEzC9wqv",84515,77429,51836,213780
1878,"Desde Coro Estado Falc√≥n apoyando las etiquetas üîñüîñ  #GuerrillaDigitalConMaduro 
üîñ
#PrevenirEsClave
Y tambi√©n #LaPazEsElCaminoDaniel2021
Si te unes sumamos voluntades en apoyo a nuestro presidente @NicolasMaduro 
üîÅ Por eso apoyo y recomiendo seguir a @wazon_bebe",49357,69917,99272,218546
1879,"Tipo de Cambio de Referencia BCV para el martes #19Oct:

Se ubic√≥ en 4,1510BsUSD presentando un incremento de 0,01 bol√≠vares üî∫(+0,2851%).",94004,59885,30238,184127
1880,@HIDROFALCON Buenas tardes para cuando agua para Antiguo Aeropuerto?,55685,93296,70376,219357
1881,@gabrielboric usted llamo a la violencia encarando en pleno estallido a un pobre pelao que estaba de punto fijo no se haga el weon estas lleno de odio y tu af√°n por figurar has hecho varias provocaciones #contigoCHV,41309,42511,42402,126222
1882,"U. E. N ""Monse√±or Acevedo"" el Cobre Estado #Tachira escuelas totalmente deterioradas efectos del socialismo. ¬øD√≥nde est√°n las autoridades competentes? https://t.co/0n78TQP627",13405,10889,20282,44576
1883,"#01Oct  #Carabobo #Sucesos Asesinan de m√∫ltiples disparos a un hombre en #Mor√≥n 
https://t.co/L6c1xbINSn https://t.co/L0a5J5vtUU",54874,29716,43514,128104
1884,"@TecnoAccesorio Kit Nintendo DsLite por 2$, incluye: 01 Lector de Tarjeta MicroSD, 03 Protector de Pantalla y 03 L√°pices punta de goma. #Nintendo #DsLite #Game #Vende #VenVariedades #Carabobo #Valencia #SanDiego #mercadolibre https://t.co/wpBp7zm03J https://t.co/ZeMpVVExjV",54892,4702,61669,121263
1885,"Sab√≠asQue | @MisionPiar_VZLA conjuntamente con @carbosuroeste brinda asistencia social a las comunidades mineras del estado #T√°chira para el impulso de la producci√≥n carbon√≠fera.

_

@NicolasMaduro 

@CVMVenezuela https://t.co/w508fYk9VI",24364,36619,61396,122379
1886,"ya que estaba medio (por no decir muy) borracha.

- estoy harta.. quiero solo verte por √∫ltima vez - *volvi√≥ a susurrar para luego sentarse en la cama y mirar a un punto fijo* 

*En ese punto ya no le importaba morir o no, a si que solo tomo una navaja que tenia en la mesa+",24741,52037,31485,108263
1887,"Y a quienes nos falta plata como hacemos, nos quedamos robados? O eso lo van  reponer?",29340,19632,85958,134930
1888,Mil Bendiciones y que tenga un feliz cumplea√±os son mis m√°s sinceros deseos Dios le d√© mucha salud y bienestar,14358,86198,28117,128673
1889,"@Banesco El d√≠a 4 de octubre realic√© una compra de 45 bs con tarjeta de d√©bito. 
Dicha transacci√≥n result√≥ fallida en el primer intento pero fue debitado el dinero.",71911,49205,91007,212123
1890,"@aacr95 Iglesia de Borojo.
Borojo es un pueblito entre  Menemauroa y Dabajuro en el estado Falcon.
La iglesia data desde la colonia.actualmente esta en peligro de https://t.co/6OP0CbttLT esta desplomando poco a poco.
@VictorClark https://t.co/s56BhDoQaJ",23619,32221,15893,71733
1891,"@sundde_ve a la tasa del ente regulador cambiario oficial BCV o en Bs a tasas no oficiales de web site anarquistas en claro delito cambiario, pues ESOS PRECIOS ACTUALES NO SON LOS MISMOS DE ANTES DE LA RECONVERSI√ìN AUN CUANDO EL $ OFICIAL SE HA MANTENIDO ESTABLE, por lo que estamos ante una",70971,5550,26481,103002
1892,"#31Agos || Extendimos la planificaci√≥n de la semana 34 beneficiando a m√°s se 61 mil familias en 13 Municipios del #Tachira, gracias al Ministro 
@LealTelleria
 
@MinAlimenVen
 nuestro reloj de atenci√≥n avanza de manera acelerada y junto a 
@FreddyBernal
 #Tachira ser√° 100% #CLAP https://t.co/i5blxMyRHo",67769,71948,72305,212022
1893,@smejiasb @Banesco esta caida no abre,11862,1666,24203,37731
1894,@HIDROFALCON y para Mar√≠a auxiliadora cuando llega el agua y para Mar√≠a auxiliadora cuando llega el agua,38812,13662,23336,75810
1895,"@naucitoh Si estuviera dormida se la puede despertar, si se hace la dormida es imposible despertarla. Yo quiero ver este momento como bisagra, no puede ser que la historia se estanque en un punto fijo. Lo dicen desde Marx hasta el I Ching.",67043,63758,36434,167235
1896,@HIDROFALCON Y las adjuntas para cuando Dios m√≠o,74463,52777,46524,173764
1897,113 nuevos contagios en Falc√≥n. https://t.co/zdKFy7S0ym,13864,38233,53095,105192
1898,Ya se sabe que est√°n trabando pero digan para cuando estar√° resuelto problema lo poquito de dinero que uno tiene para compra la comida esta ayi devaluandose cada vez m√°s La Plata digam para cuando .resuelven el problema ,59003,59386,8772,127161
1899,"¬øc√≥mo yo voy a escribir en mi tesis que el gobernador de Carabobo llama a la isla Santo Domingo, en el Parque Nacional San Esteban, ""Dracu Island"" ????? qu√© pesadilla",47946,56934,43278,148158
1900,"#NACIONALES | Habitantes de la localidad de Yekuana en el estado Bol√≠var, denunciaron una gran contaminaci√≥n en el Alto Caura consecuencia de la miner√≠a ilegal.
https://t.co/NSNO11lUKZ",98583,61976,93218,253777
1901,Qu√© te cuentas @NicolasMaduro √°garrar el tel√©fono y llamar al murci√©lago @Rafael__Lacava en los GUAYOS llevamos 11 d√≠as sin agua atenci√≥n @dcabellor x est√° raz√≥n es que @ENZOSCARANO y @williamAD29  @CaminanteAlcald @CFranmi @ArturoADelante Carabobo ganaremos.,53457,36779,58904,149140
1902,@MinMujerVe @Nelsaisabel @NicolasMaduro @MargaudGpsuv @RNVinformativa @VTVcanal8 @FmMirafloresVe @laradiodelsur @BanMujer_Ofi @InaMujer_Ve 40.000.000.000$ anuales se pueden invertir pa√≠s @NicolasMaduro @ConCiliaFlores  @TareckPSUV  @jescotet @Banesco @Bolsacaracas @Bolsa_Publica @Sunaval_Oficial @noticierovv @globovision @UNoticias @ElNacionalWeb @Mippcivzla @fedecamaras @fedeagro @Fedenaga https://t.co/2VXWpiEiaP,14444,74144,62419,151007
1903,"#Reporte: Se registra en un fuerte mega apag√≥n, en Caracas y en algunos Estados de Venezuela.

Miranda
Vargas
Distrito Capital
Cojedes
Yaracuy
Anzo√°tegui
Zulia
M√©rida
Trujillo
Tachira
Delta Amacuro
Nueva Esparta
Carabobo
Guarico
Aragua
Apure
Portuguesa
Bol√≠var
Sucre
Amazonas",70920,25171,51250,147341
1904,Desde Anzo√°tegui toda la suerte mi Almiranta...cuente con nuestra fuerza combatiente!!!,90137,83484,79545,253166
1905,"‚ÄúA partir de este momento, teniendo los mismos sentimientos de Cristo, deber√°n actuar en su nombre y como ministros de su Iglesia‚Äù
 https://t.co/8KLdn8zXjJ",90726,56797,41721,189244
1906,@Banesco amigos agencias puedo solicitar mi tarjeta de d√©bito soy de Guatire,5447,7581,31973,45001
1907,"@Adriananunezr ... convertir al Orinoco en un nuevo Guaire, crear un desierto al sur del estado Bol√≠var, poner un vertedero de basura en Guatopo...",52968,19844,74498,147310
1908,"@RedRadioVe @BCV_ORG_VE Aj√° pero pero no solo fue traki fueron  todas los negocios 
Que remarcaron precio, todo lo aumentaron, y no hicieron nada, aqu√≠ mandan son los comerciantes. Y nosotros cada d√≠a peor. Hasta cu√°ndo tenemos que aguantar esto. felices √©ramos en la cuarta rep√∫blica.",40522,62185,98595,201302
1909,@Banesco Trat√© de hacerlo ayer y es tan engorroso!! En primer lugar no todos tenemos impresora y ustedes piden dos referencias personales y el formato de huellas y firma que no pude imprimir. Fui a la p√°gina del Bco Venezuela y el cuestionario es el mismo pero no hay que imprimir nada!!!,44093,73000,95920,213013
1910,UC Aragua Universidad de Carabobo Venezuela ‚ù§Ô∏è @arlescontreras1 üîíüîíüîíüîíüîíüîíüáªüá™üê¨üê¨üê¨üê¨üê¨üê¨üê¨üê¨,6976,25289,59051,91316
1911,"@luis_villegasr @BCV_ORG_VE @delcyrodriguezv @nicmaduroguerra @ASIST_SENIAT @Mippcivzla @JuventudPSUV @EneidaLayaPsuv @almacaracas @VTVcanal8 @UNoticias @RanderPena En Puerto Ordaz no hay fiscalizaci√≥n de precios. los comerciantes son intocables, los precios por las nubes y nadie se apiada del pueblo. Delcy esos operativos me huelen a mentira",28210,28079,89380,145669
1912,Comerciante que se sirva del $$ paralelo debe ser expropiado el negocio y no puede ejercer m√°s nunca el comercio porque es LADR√ìN. El BCV es el ente responsable de administrar la divisa y los comercio e industrias deben regirse por √©ste. PLOMO AL HAMPA...,83076,95525,1501,180102
1913,Quien se opuso al @elgochoceballos    el alacr√°n @adbernabe  o la alternativa no chavista #MUD https://t.co/KCO1JZsj8S,8971,66714,15698,91383
1914,@Banesco Abr√≠ mi cuenta verde para poder abrir una cuenta en euros pero a la hora de hacer la preapertura hall√© que solo hay la opci√≥n de d√≥lares.,35600,78853,73449,187902
1915,@BODoficial Sres ahorristas veanse en el espejo de los mas de 16 mil estafados por estos delicuentes y los reguladores se hacen la vista gorda @SudebanInforma @BCV_ORG_VE @CNNEE @ekvandoorne @ANAUCO @FBI @bancaynegocios @cbcs_cur https://t.co/dB4CGrVQ9D,98873,29638,77569,206080
1916,"2021-04-11 53mm en Rivadavia, Buenos Aires, Argentina #pluviomano #gestionagro https://t.co/wYBA62Zrc9 @caburearg https://t.co/3dfm5zfWF2",87897,27419,48258,163574
1917,"Bello apartamento disponible en el pedregal, amoblado, finos acabados. Pide tu cita. #inmuebles #compra #Venta #luxuryhomes #inversion #futuro #Familia #hogar #EXCLUSIVO #Barquisimeto #Lara #Cabudare #Venezuela  https://t.co/rxNcoMYnnz",23251,10555,50842,84648
1918,#Econom√≠a Comerciantes deben vender productos a tasa de cambio del BCV https://t.co/2k8oI3l58W https://t.co/cXNWDlKX95,39703,96490,90256,226449
1919,Mochima o Cayo Sombrero. https://t.co/8gZBz8Ed4l,55267,82359,26451,164077
1920,"@NoticiasCaracol Amo Colombia!Pero en Realidad si no tuviera que conservar la ciudadan√≠a colombiana ya habr√≠a renunciado a ella!Un Tr√°mite Consular cuesta $25, y eso puede ser solo una autenticaci√≥n de Firma!Los c√≥nsules aqu√≠ de Paseo, Porque nunca est√°n y el consulado es Colombia en el exterior",79141,41423,87110,207674
1921,"üî¥SE BUSCAüî¥ Carson es una grita blanca con negro en cola y orejas, nariz rosa. Tiene 2 a√±os. Calle Halacho, Pedregal de San Nicol√°s, Tlalpan. Mediados de marzo 2021. 
CONTACTO: 5530774452 https://t.co/CEbDnQ8BZ3",48845,34267,49271,132383
1922,"Hola gente del barrio 23 de Enero en Maracay, Edo Aragua. Me gustaria tener noticias de esta zona, sobre todo a la gente que vive en la calle Carabobo, especialmente en el # 80. Si alguien pudiera hacer una foto de esta casa se lo agradeceria de antemano. Deje a Venezuela en 1989",65622,51996,5032,122650
1923,@CorpoelecInfo El parral sin electricidad valencia edo carabobo,17930,47335,26583,91848
1924,Inicia plan de vacunaci√≥n en municipios fronterizos del T√°chira - https://t.co/2G3E9uaoST https://t.co/MmRMh76BkD,29175,82232,12600,124007
1925,"@Roxarteta @SinmentirasXXI @Delineada @DarvinsonRojas @rafaelsotilloe Es tu percepci√≥n no la m√≠a! Un cl√°sico para m√≠ es un CARACAS FC VS. T√°chira. A lo mejor para otros no, solo les gusta lo que ven en otros pa√≠ses. O solo los Mundiales cada 4 a√±os, ya es asunto de cada uno! Pero el F√∫tbol Venezolano crecer√° con Nuestro Apoyo No por Magia!",55142,19120,41469,115731
1926,"Resultado que mantiene a portuguesa en el 2do. Lugar. Llegando a 33pts. Los mismos que tiene tachira pero por mejor diferencial de gol , portuguesa se mantiene 2do. Si tachira gana sera lider y le sacara 3pts al ""Penta"" y 1 a estudiantes https://t.co/zKfq7ljcnu",46961,51882,58205,157048
1927,Seguimos con nuestro mega plan de bacheo en todo el municipio Naguanagua. Gracias Ana por tu apoyo en el control y la supervisi√≥n de todo este plan para el municipio. Aqu√≠ nadie se rinde. Q viva Carabobo ü¶áü¶áü¶á https://t.co/2KBhOCpLJu,78328,56334,60099,194761
1928,"Otra victoria, nos alegra porque la defensa a la primera l√≠nea fue necesaria, gracias https://t.co/WvWmfUOZPl",49200,39505,5222,93927
1929,"Quiero la del M√°s grande del Pa√≠s, la del DVO.T√ÅCHIRA #ZonaFUTVE",35123,44458,25566,105147
1930,"""Tanto el llamado 'd√≥lar paralelo' como el 'd√≥lar BCV' han fluctuado en condiciones de libre cambio demostrando niveles de estabilidad mucho mayores a los de a√±os anteriores"".

#Columnistas Franco Vielma https://t.co/ne6G7u4BXe",71884,24064,15997,111945
1931,No creo que el T√°chira salgo aa votar por el chavismo viviendo  d√≠a a d√≠a tantas penurias . https://t.co/YLlur2GApb,71355,31963,51658,154976
1932,@RobbBanks you the king of longing we oblige by your terms... FALCONIA!,75345,76874,5455,157674
1933,"@Onyaankoopon [est√° con una mano apoyada en la cara, mirando a un punto fijo del suelo. las siguientes palabras que dijo no las dud√≥ ni un segundo] 

oh, ten por seguro que lo har√°n",67701,26494,7097,101292
1934,"üáªüá™D√ìLAR VENEZOLANO:
#Cojedes #Tinaquillo #SanCarlos #Venezuela #Colombia #C√∫cuta #Caracas #DolarToday #enparalelovzla #PuertoLaCruz #Zulia @Cotizaciones_ @LucioQuincioC  #dolarparalelo #monitordolarvzla #BCV #Bitcoin #21Octubre #Falcon #T√°chira #Margarita #EsNoticiaAhora https://t.co/h2olU9Imi8",63392,28729,61799,153920
1935,"@Banesco 
Esto es ingresando con mis datos normales o la huella. https://t.co/sG4sLcyqN3",80341,547,27495,108383
1936,@BcodeVenezuela Llevo un par de dias tratando de escanear el QR y me da este error. Que debo hacer ? https://t.co/Qcnbolb7Q2,53472,63498,54023,170993
1937,".@FreddyBernal: Logra acuerdo desde San Antonio del T√°chira para la apertura de la frontera y lo sella con un apret√≥n de manos y un buen caf√©
#FreddyAbreFronteras
üíõüñ§‚ù§Ô∏è

@NicolasMaduro @IvanDuque @delcyrodriguezv @Juntosxtachira1 @arguelloyepfri @Silfredo_Z @dcabellor https://t.co/VqSqL5ieWJ",72119,9813,50534,132466
1938,"üü¢üü¢ El @mincomercioven üáªüá™realiza despliegue este #17Oct en el Edo. Carabobo, para verificar el cumplimiento de la LOPJ y protocolos de bioseguridad, as√≠ como el uso correcto de la Nueva Expresi√≥n Monetaria.

#LaVerdadSiempreTriunfa @PR360Consultor https://t.co/HK98nl8Es6",72053,14915,5247,92215
1939,OJO con los pactos entreguistas hechos por el gobierno interino en T√°chira y El Porky contra la soberan√≠a nacional al declarar el peso colombiano como moneda de curso legal y el libre paso fronterizo. As√≠ empez√≥ el Ronquito y CAP y perdimos la 1/5 parte de pa√≠s y las minas Carbon,44503,13344,18697,76544
1940,Docente jubilada fue asesinada con un destornillador en Carabobo #20oct #enbreve #sucesos #news https://t.co/ZCQBgIsKS4,30678,73563,11296,115537
1941,"Gente, en #Carabobo vamos con todo. Acude a tu centro de electoral habilitado y familiar√≠zate con el proceso de votaci√≥n. #ElCambio es indetenible, s√∫mate. https://t.co/tTmECrGM25",38692,19279,19533,77504
1942,mi√©rcoles #06O se registran mil quinientos veinte y dos (1522) nuevos casos de #Coronavirus #Covid_19 #Carabobo con (02)ü§®ü§îpara un total ya de (377.833) contagiados en #Venezuela se suman (19) decesos‚òπÔ∏èpara un total ya de (4558) @opsoms @WHO @ONU_es @OEA_oficial #ONG #CruzRoja,40723,70460,25431,136614
1943,@angelespi7 Hola buenas d√≠as c√≥mo est√° espero que est√©s bien saludos desde Barinas rujano Jes√∫s Adolfo,91473,24237,5943,121653
1944,"@BcodeVenezuela hahahahahahahah INCOMPETENTES 

antes de poner publicidad y porner a la momia hablando Delcy Rodriguez Constaten que la pagina abre IMBECILES buenos para nada.",2190,57743,1667,61600
1945,"#26Ago En la zona norte de nuestro edo. #T√°chira los efectivos del  @GNB_tachira asisten de manera inmediata a nuestra poblaci√≥n venezolana afectada por la intesas lluvias. 

 #GNB #CEOFANB
#SomosPatriaSoberana
#GNByPuebloEnUnidad
#YoSoyFANB
.@GNBCmdtGral https://t.co/UwYr4bsHGE",81481,79799,41772,203052
1946,"En uni√≥n C√≠vico-Militar la #GNBFalc√≥n supervisan el suministro de Gas Dom√©stico con PDVSA Gas Comunal siendo beneficiadas 250 familias. #14Abr #FANB #GNB
#Nicol√°sMaduroEsPueblo
#GNByPuebloLeal
.@NicolasMaduro 
.@cmdtegralgnb
.@GNBGDjuvenal
.@LopezvargasR https://t.co/ZYRZt58gnj",94147,13821,30278,138246
1947,Rams√©s Castle  ANDO FRITO SIN PLATA Q VAINA,60375,21499,83975,165849
1948,"Sentimos el verdadero calor pol√≠tico en #PiedrasNegras, donde cientos de entusiastas, en el crucero de Rep√∫blica y Juan Pablo II, mostraron su apoyo a Norma Trevi√±o @normaltrevino.

Donde inicia Coahuila enviamos el mensaje de que ¬°vamos a ganar! https://t.co/lUJ5XhGJgI",52379,85210,79472,217061
1949,"#RT @FreddyBernal: Y me fui a #Peribeca donde ""La Catira"", yo ven√≠a con mi madre a comer dulces. ¬°Ya son 20 a√±os y siguen siendo los mejores!

#FreddyBernalGobernador 
#FreddyBernal 
#T√°chira
#AmemosAlT√°chiraüíõüñ§‚ù§Ô∏è https://t.co/bxqW393kxV",35525,77254,71757,184536
1950,"@EmmaRuedaA Hola. Ud menciona que las realiz√≥. Verific√≥ que el banco (Por mercantil o BDV, cual sea al que haya optado) hizo el respectivo d√©bito por ambos tr√°mites? La pag le indic√≥ que los pagos fueron exitosos? Llen√≥ una sola vez los datos o varias?",69884,21822,53694,145400
1951,En la ciudad de Capacho estado #Tachira...se cultiva la pi√±a m√°s dulce del pa√≠s...toda una deliciaüôèüëçüòòüòãüòãüòã https://t.co/QgcPJTjItV,65797,17471,97135,180403
1952,"Este 12 de septiembre no te quedes en casa, sal y vota. Todo esta listo para las primarias en el T√°chira, escoge el destino de tu municipio, que otro no lo haga por ti.
@JaiberthZ @laidygomezf @JuanPalenciaVE @Maiyoly @MarriaOsorio @AndreADuqueS https://t.co/qErS9ntwzu",93823,2958,3586,100367
1953,Jos√© Daniel S√°n  Co√±o t√∫ trabajas en Bancos no critiquen tanto si son toxicos esperen que ellos resuelvan ese people sea cual sea si no vallan ustedes a resolverlo dejen trabajar ustedes no son adivinos si no no tuvieran plata en ese Banco dejen esa ‚Ä¶ Ver m√°s,28382,15863,79260,123505
1954,"@NicolasMaduro Cuando liberaron el mercado cambiario (2018) dijeron que no dar√≠an ni 1 divisa a la burgues√≠a. Sugerimos ponerlo por escrito, pero el BCV ha intervenido 202 veces sin lograr detener el alza del tipo de cambio.",27901,21774,34446,84121
1955,"@salaprensaCantv @arepatecnologia @VTVcanal8 @avnve En Barrio Oeste de Naguanagua estado Carabobo,decenas de usuarios sin servicio por falta de cableado!!",38301,45925,83266,167492
1956,"@sundde_ve Hay una petshop en la Florida (frente al CC La Florida) que tiene como tasa de cambio 4,5 Bs por $. No se ajusta ni a la tasa del BCV que es el deber ser, ni menos al paralelo, deber√≠an de caerle por abusadores.",18995,2819,4400,26214
1957,"El que no tuvo infancia, porque Naci√≥ GRANDE üá≤üá® ese es @estudiantesdemeridafc #FuerzaAKD üî¥‚≠ïüáªüá™‚öΩ los 3 puntos ante #tachira se vienen a M√©rida Gracias por tantas Alegr√≠as üôèüëèüëèüëèüé∂üé∂üé∂ https://t.co/jaHbuqJGIk",91499,22005,60876,174380
1958,@AlexisCamacho16 @ZonaFUTVE @Carabobo_FC @Mabastidas ¬°Disfr√∫tala mi pana! Gracias por participar,52424,30203,66120,148747
1959,"Actualizaci√≥n 22/10/2021
09:30 AM

El MonitorDolarüîº
Bs. 4,29
El MonitorEuroüîº
Bs. 4,99
BCV=Bs. 4,21
Petro=Bs. 236,78
üáªüá™SIGUENOSüáªüá™
üëâ@MD_Vzlaüëà
#monitordolarvzla¬†#monitoreodolarvnzl¬†¬†#dolartoday¬†#dolarpromedio¬†#dolar #enparalelovzla https://t.co/HJxXs9DjP2",19127,44527,7369,71023
1960,"#15Oct #RegionesEnLaMira | @RobertLobo_: A toda esta problem√°tica en los laboratorios de Carabobo, se le suma tambi√©n la falta de reactivos y de personal. https://t.co/6S38Nc3TBU",7578,8961,4942,21481
1961,"‚≠ï Hay que prestar atenci√≥n a Carabobo, que ha sumado en dos d√≠as 168 casos (5,52 %), as√≠ como a Aragua, que lleva 126 casos (4,14 %).",58011,42762,26435,127208
1962,"@bnc_corporativo @fruben27 @SudebanInforma Lazaron con bombos y platillos la 2.0 y ni siquiera aun tienen el reconocimiento de huella? Mercantil, Provincial, Banesco lo tienen dsde hce mucho tiempo. Favor NO contestar con el bot ""tu comentario es valioso para nosotros. Seguimos trabajando para ofrecerte un mejor servicio""",29450,78307,25772,133529
1963,"T√°chira | En la trocha La Ramona fue asesinada Ruth Mar√≠a Lasso Ahumada, de 35 a√±os, por su padre, con quien ten√≠a dos hijos, uno de 18 a√±os y una de 7 a√±os. Historia completa aqu√≠: https://t.co/tNbxc2yeOx",47993,5838,74570,128401
1964,"üèÉüèΩ‚Äç‚ôÄÔ∏è‚öΩüá∏üáª| SelectaFemeninaSub20 inicia su calentamiento en la cancha #1 del Complejo Deportivo FESFUT, para el juego amistoso internacional ante #Panam√°

#ElSalvadorüá∏üáª | #SelectaFemeninaSub20 https://t.co/wpShdGhFfl",58267,80591,8223,147081
1965,"#TeBuscamos Diego Salazar Gayt√°n, 36 a√±os 1/7/16 #PiedrasNegras #Coahuila #911 https://t.co/coNa2RTqqt",57070,56202,10985,124257
1966,@dcabellor @SENIAT_Oficial En Carabobo.... Valencia zona norte.... Venimos de horas sin servicio el√©ctrico y a√∫n sin agua!!! Y nadie da noticias!!!! Ni @rafaellacava10 ni @Hidrocentro2011 ...,47630,6100,65013,118743
1967,"La #GNBFalc√≥n  Seguimos en Batalla Victoriosa Comprometidos en garantizar la Paz y Bienestar del Pueblo Venezolano.
#29Mar
#Cu√≠dateDeLaCovid19
#GNBAlertaJuntoAlPueblo
#FANBEnDefensaDeLaDignidad 
.@NicolasMaduro 
.@cmdtegralgnb
.@GNBGDjuvenal
.@LopezvargasR https://t.co/to2LKuLxUg",62981,39400,62579,164960
1968,"Impresiona el grado de abandono de la Universida de Carabobo esto parece una selva sin transporte pobres muchachos mi sobrina quedo horrorizada 
@rafaellacava10 como comienzan clases sin transporte y en esta jungla ayuda por favor!
@ngela79920809 https://t.co/k7qndqYyZ7",41894,45218,80348,167460
1969,"#DenunciaAlEspeculador | Por incumplimiento de medidas sanitarias, sobreprecios, no publicaci√≥n de la tasa del BCV ni de precios en bol√≠vares, se procedi√≥ al cierre inmediato de Hipermercado Optimista en Santa Rosal√≠a
La medida de mantiene hasta q se ajuste a la ley https://t.co/lYKXpbXVPW",12323,93110,2866,108299
1970,"#Servicio üíöü©∫Tramita tu certificado m√©dico vial en:
La Castellana, Dos Caminos, La Marr√≥n, Las Mercedes, Plaza Bol√≠var, San Antonio, Santa Paula, Los Teques, El Valle, Multiplaza Victoria, IPSFA Maracay, La Encrucijada, Las Delicias, Parque Aragua, Punto Fijo, La Vi√±a, El Vi√±edo",16627,20927,66680,104234
1971,"@AngelicaMRN todo es un mercado de oferta demanda, ellos necesitan vender tambien, si no te parece que cobren el dolar a 5,5 compras en otro lado, hay miedo respecto a la moneda(bolivar) por la reconversion y otras vainas que ha hecho el BCV, poco a poco se va a estabilizar cuando",26520,18074,26297,70891
1972,"Estado Mayor de #FANB en el edo Bol√≠var realiz√≥ inspecci√≥n a la Central Hidroel√©ctrica Antonio Jos√© de Sucre en Macagua, garantizando el buen funcionamiento de sus instalaciones.

#13Oct PuebloPatriota
#Mon√≥merosEsDeVenezuela
UnidosPuebloyGNBEsSoberan√≠a https://t.co/UQqgMTzCHq",73318,77924,52796,204038
1973,"#GNBFalc√≥n, prestan Seguridad a las instalaciones de las plantas El√©ctricas en todo el territorio Falconiano.
#30Mar #FANB
#SputnikVContraCovid
#GNByPuebloEnVictoria
#FANBEnDefensaDeLaDignidad .@NicolasMaduro .@cmdtegralgnb .@GNBGDjuvenal .@LopezvargasR
https://t.co/pA98gsvjjf",85324,98086,52162,235572
1974,"La #GNBFalc√≥n realizaron pr√°ctica de Orden P√∫blico, con el fin de fortalecer las habilidades en el mantenimiento del orden interno. #15Abr #FANB
#Flexibilizaci√≥nConsciente
#GNByPuebloVenciendo
.@NicolasMaduro 
.@cmdtegralgnb
.@GNBGDjuvenal
.@LopezvargasR https://t.co/tGVz2eKsRM",12100,39793,66661,118554
1975,Creo que es el primer juego del Carabobo que no vere en el a√±o,71128,50408,11051,132587
1976,"@caribeINDIOX @traffiCARACAS @carlosluhernan1 Ja ja esa cantidad no afecta la inflaci√≥n, el gobierno maneja presupuestos de varios millones de d√≥lares todos los d√≠as, s√≥lo hacer unas reparaciones en alguna dependencia p√∫blica cuesta eso, nada m√°s en media de cambio son 50 millones diario https://t.co/DWPJdhwMnk",62423,86324,4476,153223
1977,Esa proteina  animal no  llega  a  las  aguita municipio los guayos carabobo y el  presidente  cree que  llega  para todos  y el clap cada 4 meses  y no trae  todos  los  productos  que  dice el presidente,41604,52507,68087,162198
1978,@NestorLReverol @EdwinRojasM @delcyrodriguezv @mppeevzla @CorpoelecInfo @VTVcanal8 @vladimirpadrino @TareckPSUV @jaarreaza @ViceVenezuela @dcabellor @luchaalmada En tazajal naguanagua edo carabobo esta es la 5ta vez q se nos va la luz. Ayuda por favor camarada nos da√±an los artefactos electricos,20158,31390,31290,82838
1979,@FaiberChacon3 No es romperla. Es fortalecerla . Por momento zamora obliga a T√°chira a meterse en demas√≠a atr√°s y necesita que alguno le de salida mas r√°pida al equipo. Nelson puede partir desde esa linea buscando la conexion con chacon,37536,47514,48819,133869
1980,La Juventud Emprendedora del Frente de Profesionales y T√©cnicos del Estado Bol√≠varüë®‚Äçüéì Realiza Exitoso Registro para la Certificaci√≥n de Saberes con el INCES en el Mcpio. Angostura del Orinoco. Jornada que se extender√° hasta el 15 de Octubre 2021. ¬°Viva la Juventud! @JuventudPSUV https://t.co/EuwmQRsqm0,75648,98025,70601,244274
1981,@laidygomezf @GobiernoTachira @ivt_tachira Pareja con una ni√±a de aprox 6a√±os duermen en la esquina de Gina desde el Domingo pasado y ning√∫n ente gubernamental pasa por ah√≠.,40500,33758,70885,145143
1982,"Patrullaje de Seguridad en las instituciones Universitarias del Mun Maturin #Monagas üö®üò∑

.@GNB_Monagas
#8Abr #FANB #GNB
#JuntosContraLaCOVID19
#GNBEsPueblo
#PuebloYFANBPorLaPatria
.@NicolasMaduro 
.@cmdtegralgnb
.@GNBGDjuvenal
.@LopezvargasR #GNBFalc√≥n https://t.co/3lCyQGvYf7",40292,67526,52729,160547
1983,"Cdi panamericano Tachira
#MmedicalCubanaTachira 
#HeroesDeLaSalud 
#ACubaPonleCorazon 
#CubaPorLaVida 
@CDIPanamerican1 https://t.co/XjFM4ehsaS",20474,61773,64495,146742
1984,"Por una revoluci√≥n como la nuestra
Desde el CDI Bella Vista
Estado Bolivar
#SomosContinuidad 
#FidelidadACuba
#heroresdelasalud https://t.co/bxJdeMWrPt",49069,6206,80289,135564
1985,Reporte del incendio forestal en la colonia Fuentes del Pedregal  perif√©rico Sur  contin√∫an laborando bomberos CDMX. https://t.co/4c2dqgpS5X,9073,67891,17295,94259
1986,La negra YAJAIRA GARC√çA el Hurac√°n de la Esperanza y PEDRO MATA el Gobernador del Estado Bol√≠var contin√∫an con sus visitas casa por casa en las diversas comunidades de Guayana! VOTA PROYECTO GUAYANA https://t.co/5YEldGQARY,4805,63523,71238,139566
1987,#FelizS√°bado #PiedrasNegras ‚òÄ Hoy en portada: Repelen militares ataque en Ribere√±a üëÆ‚Äç‚ôÇÔ∏èüöîüëâ https://t.co/6lWpodSLt9 https://t.co/encCg0Y1Jm,29985,88916,1884,120785
1988,"#T√°chira Leyendas que se esconden en el cementerio de San Crist√≥bal 
#1Sep 
https://t.co/FqXcdzIqjC",50672,15999,14132,80803
1989,"üîµ#09Oct | #Sabado  #AHORA 01:15 pm OTRA VEZ #SinAgua en #LaIsabelica, #Valencia #Carabobo 
¬øY el #Agua pa cuando?
¬øC√≥mo vamos a prevenir
#Covid_19?
Que √±ema con √©stos incompetentes 
#ATENCI√ìN
.@Hidrocentro2011
.@MPPAAguas
.@rafaellacava10 
.@EvelynBVasquez https://t.co/PfJtV409vx",20134,49436,80531,150101
1990,"""CHICHIRIVICHE"" por Sim√≥n D√≠az‚Äã 

Las playas m√°s hermosas de este mundo
Chichiriviche, T

#Acordes #Letras #Sim√≥nD√≠az #Sim√≥nD√≠az

https://t.co/fAfEsqoDbg",32982,77156,88607,198745
1991,Daniel_RiosVE: Duermen en el piso: ni√±os vulnerables bajo tutela de un condado de California viven en condiciones deplorables https://t.co/ySN1fBEzRK #DanielRiosTeInforma #GacetaCarabobo #Carabobo #Venezuela,68308,27104,4917,100329
1992,"@MonitorDolarOf ¬øSi los ""comerciantes"" se rigen es por el dolar BCV, por qu√© entran a ver est√° p√°gina?

¬øO  solo se rigen  cuando el dolar BCV est√°  por encima del paralelo?",6701,88516,64665,159882
1993,"Con la fuerza y el liderazgo de candidatos trabajadores  el PPT Bolivar asume el compromiso de fortalecer desde la gobernaci√≥n del estado con @amarcanopsuv un gobierno para todos los guayaneses #PPTLafuerzaDeLaEspetanza
@PPTPrensa 
@NerioFuentes6 
@PPTIleniMedina",14238,84723,13518,112479
1994,"@rmfinanzas @BcodeVenezuela Y a los que le robaron el dinero, para cu√°ndo puedo ir a comprar a√∫n que sea unos huevos? Porque est√° m√°s q evidente q con la reconversi√≥n quedamos m√°s pobres",17935,41164,7350,66449
1995,"En el silencio cual adversario respond√≠a aprovechaba de pensar m√°s l√≠neas cuales utilizar. Hacer memoria de algo en especial, que le sirva.
Las caricias detuvo moment√°neamente, simulando el estar congelada o concentrada en un punto fijo. 
‚Äî Oh, perdone, me he distra√≠do. ‚Äî (+)",83625,38125,37543,159293
1996,"#DeInter√©s üìÉ #GNB y @sundde_ve supervisan comercios en el estado Bol√≠var

Noticia ‚û°Ô∏èhttps://t.co/4FlaTxvP6e

#6Oct CEOFANBPorLaPatria
#Producci√≥nEnMarcha
#GNBBol√≠var
 PuebloyFANBInvencibles
#GNBCmdteDesurBolivar 
.@vladimirpadrino
.@GNBCmdtGral
https://t.co/2uRAlqzptZ",91529,47045,66328,204902
1997,Acaba de publicar una foto en Safari Carabobo Country Club https://t.co/JqRAE6L2xs,47485,51526,1738,100749
1998,"@CaricaturasVe @carmics1 PORQU√â CERRAR EL BANCO CENTRAL DE VENEZUELA? PARA arrebatarle el poder a los pol√≠ticos de hacernos pobres mientras ellos se hacen ricos.
(Ver video)

https://t.co/nz2HkSPSUR

""El banco Central no tiene reservas. Son solo ajustes contables. No hay respaldo. Son negativas"" https://t.co/ljh0030I5R",18375,28085,50414,96874
1999,Un polic√≠a muere y otro herido tras ser embestidos por un veh√≠culo cerca del Capitolio de EE.UU https://t.co/8IEZQycTPK,12712,28210,30977,71899
